"filename", "language", "Properties", "Batch", "PowerShell", "Python", "XML", "comment", "blank", "total"
"c:\Users\edwar\OneDrive\Documents\Programming\Visual Studio 2022\PARTS_Web\app\bot_env\Lib\site-packages\pip\__init__.py", "Python", 0, 0, 0, -8, 0, 0, -6, -14
"c:\Users\edwar\OneDrive\Documents\Programming\Visual Studio 2022\PARTS_Web\app\bot_env\Lib\site-packages\pip\__main__.py", "Python", 0, 0, 0, -10, 0, -10, -5, -25
"c:\Users\edwar\OneDrive\Documents\Programming\Visual Studio 2022\PARTS_Web\app\bot_env\Lib\site-packages\pip\__pip-runner__.py", "Python", 0, 0, 0, -29, 0, -4, -18, -51
"c:\Users\edwar\OneDrive\Documents\Programming\Visual Studio 2022\PARTS_Web\app\bot_env\Lib\site-packages\pip\_internal\__init__.py", "Python", 0, 0, 0, -10, 0, -2, -7, -19
"c:\Users\edwar\OneDrive\Documents\Programming\Visual Studio 2022\PARTS_Web\app\bot_env\Lib\site-packages\pip\_internal\build_env.py", "Python", 0, 0, 0, -252, 0, -15, -45, -312
"c:\Users\edwar\OneDrive\Documents\Programming\Visual Studio 2022\PARTS_Web\app\bot_env\Lib\site-packages\pip\_internal\cache.py", "Python", 0, 0, 0, -221, 0, -19, -51, -291
"c:\Users\edwar\OneDrive\Documents\Programming\Visual Studio 2022\PARTS_Web\app\bot_env\Lib\site-packages\pip\_internal\cli\__init__.py", "Python", 0, 0, 0, -2, 0, -1, -2, -5
"c:\Users\edwar\OneDrive\Documents\Programming\Visual Studio 2022\PARTS_Web\app\bot_env\Lib\site-packages\pip\_internal\cli\autocompletion.py", "Python", 0, 0, 0, -135, 0, -19, -19, -173
"c:\Users\edwar\OneDrive\Documents\Programming\Visual Studio 2022\PARTS_Web\app\bot_env\Lib\site-packages\pip\_internal\cli\base_command.py", "Python", 0, 0, 0, -175, 0, -22, -40, -237
"c:\Users\edwar\OneDrive\Documents\Programming\Visual Studio 2022\PARTS_Web\app\bot_env\Lib\site-packages\pip\_internal\cli\cmdoptions.py", "Python", 0, 0, 0, -883, 0, -38, -154, -1075
"c:\Users\edwar\OneDrive\Documents\Programming\Visual Studio 2022\PARTS_Web\app\bot_env\Lib\site-packages\pip\_internal\cli\command_context.py", "Python", 0, 0, 0, -20, 0, 0, -8, -28
"c:\Users\edwar\OneDrive\Documents\Programming\Visual Studio 2022\PARTS_Web\app\bot_env\Lib\site-packages\pip\_internal\cli\main.py", "Python", 0, 0, 0, -34, 0, -30, -16, -80
"c:\Users\edwar\OneDrive\Documents\Programming\Visual Studio 2022\PARTS_Web\app\bot_env\Lib\site-packages\pip\_internal\cli\main_parser.py", "Python", 0, 0, 0, -82, 0, -24, -29, -135
"c:\Users\edwar\OneDrive\Documents\Programming\Visual Studio 2022\PARTS_Web\app\bot_env\Lib\site-packages\pip\_internal\cli\parser.py", "Python", 0, 0, 0, -222, 0, -20, -53, -295
"c:\Users\edwar\OneDrive\Documents\Programming\Visual Studio 2022\PARTS_Web\app\bot_env\Lib\site-packages\pip\_internal\cli\progress_bars.py", "Python", 0, 0, 0, -58, 0, 0, -11, -69
"c:\Users\edwar\OneDrive\Documents\Programming\Visual Studio 2022\PARTS_Web\app\bot_env\Lib\site-packages\pip\_internal\cli\req_command.py", "Python", 0, 0, 0, -408, 0, -29, -69, -506
"c:\Users\edwar\OneDrive\Documents\Programming\Visual Studio 2022\PARTS_Web\app\bot_env\Lib\site-packages\pip\_internal\cli\spinners.py", "Python", 0, 0, 0, -114, 0, -18, -28, -160
"c:\Users\edwar\OneDrive\Documents\Programming\Visual Studio 2022\PARTS_Web\app\bot_env\Lib\site-packages\pip\_internal\cli\status_codes.py", "Python", 0, 0, 0, -6, 0, 0, -1, -7
"c:\Users\edwar\OneDrive\Documents\Programming\Visual Studio 2022\PARTS_Web\app\bot_env\Lib\site-packages\pip\_internal\commands\__init__.py", "Python", 0, 0, 0, -113, 0, -7, -13, -133
"c:\Users\edwar\OneDrive\Documents\Programming\Visual Studio 2022\PARTS_Web\app\bot_env\Lib\site-packages\pip\_internal\commands\cache.py", "Python", 0, 0, 0, -163, 0, -20, -43, -226
"c:\Users\edwar\OneDrive\Documents\Programming\Visual Studio 2022\PARTS_Web\app\bot_env\Lib\site-packages\pip\_internal\commands\check.py", "Python", 0, 0, 0, -45, 0, 0, -10, -55
"c:\Users\edwar\OneDrive\Documents\Programming\Visual Studio 2022\PARTS_Web\app\bot_env\Lib\site-packages\pip\_internal\commands\completion.py", "Python", 0, 0, 0, -116, 0, -5, -10, -131
"c:\Users\edwar\OneDrive\Documents\Programming\Visual Studio 2022\PARTS_Web\app\bot_env\Lib\site-packages\pip\_internal\commands\configuration.py", "Python", 0, 0, 0, -224, 0, -12, -45, -281
"c:\Users\edwar\OneDrive\Documents\Programming\Visual Studio 2022\PARTS_Web\app\bot_env\Lib\site-packages\pip\_internal\commands\debug.py", "Python", 0, 0, 0, -149, 0, -9, -44, -202
"c:\Users\edwar\OneDrive\Documents\Programming\Visual Studio 2022\PARTS_Web\app\bot_env\Lib\site-packages\pip\_internal\commands\download.py", "Python", 0, 0, 0, -117, 0, -2, -29, -148
"c:\Users\edwar\OneDrive\Documents\Programming\Visual Studio 2022\PARTS_Web\app\bot_env\Lib\site-packages\pip\_internal\commands\freeze.py", "Python", 0, 0, 0, -91, 0, 0, -18, -109
"c:\Users\edwar\OneDrive\Documents\Programming\Visual Studio 2022\PARTS_Web\app\bot_env\Lib\site-packages\pip\_internal\commands\hash.py", "Python", 0, 0, 0, -48, 0, 0, -12, -60
"c:\Users\edwar\OneDrive\Documents\Programming\Visual Studio 2022\PARTS_Web\app\bot_env\Lib\site-packages\pip\_internal\commands\help.py", "Python", 0, 0, 0, -29, 0, -1, -12, -42
"c:\Users\edwar\OneDrive\Documents\Programming\Visual Studio 2022\PARTS_Web\app\bot_env\Lib\site-packages\pip\_internal\commands\index.py", "Python", 0, 0, 0, -108, 0, -4, -28, -140
"c:\Users\edwar\OneDrive\Documents\Programming\Visual Studio 2022\PARTS_Web\app\bot_env\Lib\site-packages\pip\_internal\commands\inspect.py", "Python", 0, 0, 0, -77, 0, -6, -10, -93
"c:\Users\edwar\OneDrive\Documents\Programming\Visual Studio 2022\PARTS_Web\app\bot_env\Lib\site-packages\pip\_internal\commands\install.py", "Python", 0, 0, 0, -646, 0, -36, -93, -775
"c:\Users\edwar\OneDrive\Documents\Programming\Visual Studio 2022\PARTS_Web\app\bot_env\Lib\site-packages\pip\_internal\commands\list.py", "Python", 0, 0, 0, -299, 0, -13, -57, -369
"c:\Users\edwar\OneDrive\Documents\Programming\Visual Studio 2022\PARTS_Web\app\bot_env\Lib\site-packages\pip\_internal\commands\search.py", "Python", 0, 0, 0, -142, 0, -2, -31, -175
"c:\Users\edwar\OneDrive\Documents\Programming\Visual Studio 2022\PARTS_Web\app\bot_env\Lib\site-packages\pip\_internal\commands\show.py", "Python", 0, 0, 0, -162, 0, 0, -28, -190
"c:\Users\edwar\OneDrive\Documents\Programming\Visual Studio 2022\PARTS_Web\app\bot_env\Lib\site-packages\pip\_internal\commands\uninstall.py", "Python", 0, 0, 0, -99, 0, 0, -15, -114
"c:\Users\edwar\OneDrive\Documents\Programming\Visual Studio 2022\PARTS_Web\app\bot_env\Lib\site-packages\pip\_internal\commands\wheel.py", "Python", 0, 0, 0, -151, 0, -2, -31, -184
"c:\Users\edwar\OneDrive\Documents\Programming\Visual Studio 2022\PARTS_Web\app\bot_env\Lib\site-packages\pip\_internal\configuration.py", "Python", 0, 0, 0, -279, 0, -33, -72, -384
"c:\Users\edwar\OneDrive\Documents\Programming\Visual Studio 2022\PARTS_Web\app\bot_env\Lib\site-packages\pip\_internal\distributions\__init__.py", "Python", 0, 0, 0, -13, 0, -4, -5, -22
"c:\Users\edwar\OneDrive\Documents\Programming\Visual Studio 2022\PARTS_Web\app\bot_env\Lib\site-packages\pip\_internal\distributions\base.py", "Python", 0, 0, 0, -38, 0, 0, -14, -52
"c:\Users\edwar\OneDrive\Documents\Programming\Visual Studio 2022\PARTS_Web\app\bot_env\Lib\site-packages\pip\_internal\distributions\installed.py", "Python", 0, 0, 0, -22, 0, 0, -8, -30
"c:\Users\edwar\OneDrive\Documents\Programming\Visual Studio 2022\PARTS_Web\app\bot_env\Lib\site-packages\pip\_internal\distributions\sdist.py", "Python", 0, 0, 0, -122, 0, -18, -17, -157
"c:\Users\edwar\OneDrive\Documents\Programming\Visual Studio 2022\PARTS_Web\app\bot_env\Lib\site-packages\pip\_internal\distributions\wheel.py", "Python", 0, 0, 0, -32, 0, 0, -9, -41
"c:\Users\edwar\OneDrive\Documents\Programming\Visual Studio 2022\PARTS_Web\app\bot_env\Lib\site-packages\pip\_internal\exceptions.py", "Python", 0, 0, 0, -546, 0, -23, -160, -729
"c:\Users\edwar\OneDrive\Documents\Programming\Visual Studio 2022\PARTS_Web\app\bot_env\Lib\site-packages\pip\_internal\index\__init__.py", "Python", 0, 0, 0, -2, 0, 0, -1, -3
"c:\Users\edwar\OneDrive\Documents\Programming\Visual Studio 2022\PARTS_Web\app\bot_env\Lib\site-packages\pip\_internal\index\collector.py", "Python", 0, 0, 0, -393, 0, -29, -86, -508
"c:\Users\edwar\OneDrive\Documents\Programming\Visual Studio 2022\PARTS_Web\app\bot_env\Lib\site-packages\pip\_internal\index\package_finder.py", "Python", 0, 0, 0, -842, 0, -39, -147, -1028
"c:\Users\edwar\OneDrive\Documents\Programming\Visual Studio 2022\PARTS_Web\app\bot_env\Lib\site-packages\pip\_internal\index\sources.py", "Python", 0, 0, 0, -224, 0, -3, -59, -286
"c:\Users\edwar\OneDrive\Documents\Programming\Visual Studio 2022\PARTS_Web\app\bot_env\Lib\site-packages\pip\_internal\locations\__init__.py", "Python", 0, 0, 0, -345, 0, -37, -86, -468
"c:\Users\edwar\OneDrive\Documents\Programming\Visual Studio 2022\PARTS_Web\app\bot_env\Lib\site-packages\pip\_internal\locations\_distutils.py", "Python", 0, 0, 0, -127, 0, -21, -25, -173
"c:\Users\edwar\OneDrive\Documents\Programming\Visual Studio 2022\PARTS_Web\app\bot_env\Lib\site-packages\pip\_internal\locations\_sysconfig.py", "Python", 0, 0, 0, -158, 0, -17, -39, -214
"c:\Users\edwar\OneDrive\Documents\Programming\Visual Studio 2022\PARTS_Web\app\bot_env\Lib\site-packages\pip\_internal\locations\base.py", "Python", 0, 0, 0, -55, 0, -8, -19, -82
"c:\Users\edwar\OneDrive\Documents\Programming\Visual Studio 2022\PARTS_Web\app\bot_env\Lib\site-packages\pip\_internal\main.py", "Python", 0, 0, 0, -8, 0, 0, -5, -13
"c:\Users\edwar\OneDrive\Documents\Programming\Visual Studio 2022\PARTS_Web\app\bot_env\Lib\site-packages\pip\_internal\metadata\__init__.py", "Python", 0, 0, 0, -96, 0, 0, -33, -129
"c:\Users\edwar\OneDrive\Documents\Programming\Visual Studio 2022\PARTS_Web\app\bot_env\Lib\site-packages\pip\_internal\metadata\_json.py", "Python", 0, 0, 0, -68, 0, -6, -11, -85
"c:\Users\edwar\OneDrive\Documents\Programming\Visual Studio 2022\PARTS_Web\app\bot_env\Lib\site-packages\pip\_internal\metadata\base.py", "Python", 0, 0, 0, -564, 0, -15, -124, -703
"c:\Users\edwar\OneDrive\Documents\Programming\Visual Studio 2022\PARTS_Web\app\bot_env\Lib\site-packages\pip\_internal\metadata\importlib\__init__.py", "Python", 0, 0, 0, -4, 0, 0, -3, -7
"c:\Users\edwar\OneDrive\Documents\Programming\Visual Studio 2022\PARTS_Web\app\bot_env\Lib\site-packages\pip\_internal\metadata\importlib\_compat.py", "Python", 0, 0, 0, -40, 0, 0, -16, -56
"c:\Users\edwar\OneDrive\Documents\Programming\Visual Studio 2022\PARTS_Web\app\bot_env\Lib\site-packages\pip\_internal\metadata\importlib\_dists.py", "Python", 0, 0, 0, -184, 0, -12, -32, -228
"c:\Users\edwar\OneDrive\Documents\Programming\Visual Studio 2022\PARTS_Web\app\bot_env\Lib\site-packages\pip\_internal\metadata\importlib\_envs.py", "Python", 0, 0, 0, -150, 0, -6, -34, -190
"c:\Users\edwar\OneDrive\Documents\Programming\Visual Studio 2022\PARTS_Web\app\bot_env\Lib\site-packages\pip\_internal\metadata\pkg_resources.py", "Python", 0, 0, 0, -212, 0, -17, -50, -279
"c:\Users\edwar\OneDrive\Documents\Programming\Visual Studio 2022\PARTS_Web\app\bot_env\Lib\site-packages\pip\_internal\models\__init__.py", "Python", 0, 0, 0, -2, 0, 0, -1, -3
"c:\Users\edwar\OneDrive\Documents\Programming\Visual Studio 2022\PARTS_Web\app\bot_env\Lib\site-packages\pip\_internal\models\candidate.py", "Python", 0, 0, 0, -22, 0, 0, -9, -31
"c:\Users\edwar\OneDrive\Documents\Programming\Visual Studio 2022\PARTS_Web\app\bot_env\Lib\site-packages\pip\_internal\models\direct_url.py", "Python", 0, 0, 0, -190, 0, -3, -43, -236
"c:\Users\edwar\OneDrive\Documents\Programming\Visual Studio 2022\PARTS_Web\app\bot_env\Lib\site-packages\pip\_internal\models\format_control.py", "Python", 0, 0, 0, -63, 0, -1, -15, -79
"c:\Users\edwar\OneDrive\Documents\Programming\Visual Studio 2022\PARTS_Web\app\bot_env\Lib\site-packages\pip\_internal\models\index.py", "Python", 0, 0, 0, -17, 0, -3, -9, -29
"c:\Users\edwar\OneDrive\Documents\Programming\Visual Studio 2022\PARTS_Web\app\bot_env\Lib\site-packages\pip\_internal\models\installation_report.py", "Python", 0, 0, 0, -29, 0, -21, -7, -57
"c:\Users\edwar\OneDrive\Documents\Programming\Visual Studio 2022\PARTS_Web\app\bot_env\Lib\site-packages\pip\_internal\models\link.py", "Python", 0, 0, 0, -427, 0, -54, -99, -580
"c:\Users\edwar\OneDrive\Documents\Programming\Visual Studio 2022\PARTS_Web\app\bot_env\Lib\site-packages\pip\_internal\models\scheme.py", "Python", 0, 0, 0, -24, 0, 0, -8, -32
"c:\Users\edwar\OneDrive\Documents\Programming\Visual Studio 2022\PARTS_Web\app\bot_env\Lib\site-packages\pip\_internal\models\search_scope.py", "Python", 0, 0, 0, -93, 0, -18, -22, -133
"c:\Users\edwar\OneDrive\Documents\Programming\Visual Studio 2022\PARTS_Web\app\bot_env\Lib\site-packages\pip\_internal\models\selection_prefs.py", "Python", 0, 0, 0, -40, 0, -4, -8, -52
"c:\Users\edwar\OneDrive\Documents\Programming\Visual Studio 2022\PARTS_Web\app\bot_env\Lib\site-packages\pip\_internal\models\target_python.py", "Python", 0, 0, 0, -98, 0, -4, -21, -123
"c:\Users\edwar\OneDrive\Documents\Programming\Visual Studio 2022\PARTS_Web\app\bot_env\Lib\site-packages\pip\_internal\models\wheel.py", "Python", 0, 0, 0, -71, 0, -3, -19, -93
"c:\Users\edwar\OneDrive\Documents\Programming\Visual Studio 2022\PARTS_Web\app\bot_env\Lib\site-packages\pip\_internal\network\__init__.py", "Python", 0, 0, 0, -2, 0, 0, -1, -3
"c:\Users\edwar\OneDrive\Documents\Programming\Visual Studio 2022\PARTS_Web\app\bot_env\Lib\site-packages\pip\_internal\network\auth.py", "Python", 0, 0, 0, -387, 0, -71, -104, -562
"c:\Users\edwar\OneDrive\Documents\Programming\Visual Studio 2022\PARTS_Web\app\bot_env\Lib\site-packages\pip\_internal\network\cache.py", "Python", 0, 0, 0, -80, 0, -5, -22, -107
"c:\Users\edwar\OneDrive\Documents\Programming\Visual Studio 2022\PARTS_Web\app\bot_env\Lib\site-packages\pip\_internal\network\download.py", "Python", 0, 0, 0, -150, 0, -3, -34, -187
"c:\Users\edwar\OneDrive\Documents\Programming\Visual Studio 2022\PARTS_Web\app\bot_env\Lib\site-packages\pip\_internal\network\lazy_wheel.py", "Python", 0, 0, 0, -166, 0, -7, -38, -211
"c:\Users\edwar\OneDrive\Documents\Programming\Visual Studio 2022\PARTS_Web\app\bot_env\Lib\site-packages\pip\_internal\network\session.py", "Python", 0, 0, 0, -359, 0, -81, -81, -521
"c:\Users\edwar\OneDrive\Documents\Programming\Visual Studio 2022\PARTS_Web\app\bot_env\Lib\site-packages\pip\_internal\network\utils.py", "Python", 0, 0, 0, -39, 0, -47, -11, -97
"c:\Users\edwar\OneDrive\Documents\Programming\Visual Studio 2022\PARTS_Web\app\bot_env\Lib\site-packages\pip\_internal\network\xmlrpc.py", "Python", 0, 0, 0, -53, 0, 0, -10, -63
"c:\Users\edwar\OneDrive\Documents\Programming\Visual Studio 2022\PARTS_Web\app\bot_env\Lib\site-packages\pip\_internal\operations\__init__.py", "Python", 0, 0, 0, 0, 0, 0, -1, -1
"c:\Users\edwar\OneDrive\Documents\Programming\Visual Studio 2022\PARTS_Web\app\bot_env\Lib\site-packages\pip\_internal\operations\check.py", "Python", 0, 0, 0, -138, 0, -10, -40, -188
"c:\Users\edwar\OneDrive\Documents\Programming\Visual Studio 2022\PARTS_Web\app\bot_env\Lib\site-packages\pip\_internal\operations\freeze.py", "Python", 0, 0, 0, -214, 0, -12, -30, -256
"c:\Users\edwar\OneDrive\Documents\Programming\Visual Studio 2022\PARTS_Web\app\bot_env\Lib\site-packages\pip\_internal\operations\install\__init__.py", "Python", 0, 0, 0, -2, 0, 0, -1, -3
"c:\Users\edwar\OneDrive\Documents\Programming\Visual Studio 2022\PARTS_Web\app\bot_env\Lib\site-packages\pip\_internal\operations\install\editable_legacy.py", "Python", 0, 0, 0, -40, 0, 0, -7, -47
"c:\Users\edwar\OneDrive\Documents\Programming\Visual Studio 2022\PARTS_Web\app\bot_env\Lib\site-packages\pip\_internal\operations\install\wheel.py", "Python", 0, 0, 0, -523, 0, -94, -118, -735
"c:\Users\edwar\OneDrive\Documents\Programming\Visual Studio 2022\PARTS_Web\app\bot_env\Lib\site-packages\pip\_internal\operations\prepare.py", "Python", 0, 0, 0, -529, 0, -113, -89, -731
"c:\Users\edwar\OneDrive\Documents\Programming\Visual Studio 2022\PARTS_Web\app\bot_env\Lib\site-packages\pip\_internal\pyproject.py", "Python", 0, 0, 0, -106, 0, -45, -29, -180
"c:\Users\edwar\OneDrive\Documents\Programming\Visual Studio 2022\PARTS_Web\app\bot_env\Lib\site-packages\pip\_internal\req\__init__.py", "Python", 0, 0, 0, -73, 0, -1, -19, -93
"c:\Users\edwar\OneDrive\Documents\Programming\Visual Studio 2022\PARTS_Web\app\bot_env\Lib\site-packages\pip\_internal\req\constructors.py", "Python", 0, 0, 0, -474, 0, -24, -79, -577
"c:\Users\edwar\OneDrive\Documents\Programming\Visual Studio 2022\PARTS_Web\app\bot_env\Lib\site-packages\pip\_internal\req\req_file.py", "Python", 0, 0, 0, -426, 0, -34, -95, -555
"c:\Users\edwar\OneDrive\Documents\Programming\Visual Studio 2022\PARTS_Web\app\bot_env\Lib\site-packages\pip\_internal\req\req_install.py", "Python", 0, 0, 0, -738, 0, -77, -109, -924
"c:\Users\edwar\OneDrive\Documents\Programming\Visual Studio 2022\PARTS_Web\app\bot_env\Lib\site-packages\pip\_internal\req\req_set.py", "Python", 0, 0, 0, -97, 0, 0, -23, -120
"c:\Users\edwar\OneDrive\Documents\Programming\Visual Studio 2022\PARTS_Web\app\bot_env\Lib\site-packages\pip\_internal\req\req_uninstall.py", "Python", 0, 0, 0, -489, 0, -57, -104, -650
"c:\Users\edwar\OneDrive\Documents\Programming\Visual Studio 2022\PARTS_Web\app\bot_env\Lib\site-packages\pip\_internal\resolution\__init__.py", "Python", 0, 0, 0, 0, 0, 0, -1, -1
"c:\Users\edwar\OneDrive\Documents\Programming\Visual Studio 2022\PARTS_Web\app\bot_env\Lib\site-packages\pip\_internal\resolution\base.py", "Python", 0, 0, 0, -15, 0, 0, -6, -21
"c:\Users\edwar\OneDrive\Documents\Programming\Visual Studio 2022\PARTS_Web\app\bot_env\Lib\site-packages\pip\_internal\resolution\legacy\__init__.py", "Python", 0, 0, 0, 0, 0, 0, -1, -1
"c:\Users\edwar\OneDrive\Documents\Programming\Visual Studio 2022\PARTS_Web\app\bot_env\Lib\site-packages\pip\_internal\resolution\legacy\resolver.py", "Python", 0, 0, 0, -448, 0, -70, -81, -599
"c:\Users\edwar\OneDrive\Documents\Programming\Visual Studio 2022\PARTS_Web\app\bot_env\Lib\site-packages\pip\_internal\resolution\resolvelib\__init__.py", "Python", 0, 0, 0, 0, 0, 0, -1, -1
"c:\Users\edwar\OneDrive\Documents\Programming\Visual Studio 2022\PARTS_Web\app\bot_env\Lib\site-packages\pip\_internal\resolution\resolvelib\base.py", "Python", 0, 0, 0, -103, 0, -4, -35, -142
"c:\Users\edwar\OneDrive\Documents\Programming\Visual Studio 2022\PARTS_Web\app\bot_env\Lib\site-packages\pip\_internal\resolution\resolvelib\candidates.py", "Python", 0, 0, 0, -470, 0, -29, -99, -598
"c:\Users\edwar\OneDrive\Documents\Programming\Visual Studio 2022\PARTS_Web\app\bot_env\Lib\site-packages\pip\_internal\resolution\resolvelib\factory.py", "Python", 0, 0, 0, -656, 0, -77, -80, -813
"c:\Users\edwar\OneDrive\Documents\Programming\Visual Studio 2022\PARTS_Web\app\bot_env\Lib\site-packages\pip\_internal\resolution\resolvelib\found_candidates.py", "Python", 0, 0, 0, -112, 0, -18, -26, -156
"c:\Users\edwar\OneDrive\Documents\Programming\Visual Studio 2022\PARTS_Web\app\bot_env\Lib\site-packages\pip\_internal\resolution\resolvelib\provider.py", "Python", 0, 0, 0, -191, 0, -29, -36, -256
"c:\Users\edwar\OneDrive\Documents\Programming\Visual Studio 2022\PARTS_Web\app\bot_env\Lib\site-packages\pip\_internal\resolution\resolvelib\reporter.py", "Python", 0, 0, 0, -60, 0, -1, -20, -81
"c:\Users\edwar\OneDrive\Documents\Programming\Visual Studio 2022\PARTS_Web\app\bot_env\Lib\site-packages\pip\_internal\resolution\resolvelib\requirements.py", "Python", 0, 0, 0, -110, 0, -12, -45, -167
"c:\Users\edwar\OneDrive\Documents\Programming\Visual Studio 2022\PARTS_Web\app\bot_env\Lib\site-packages\pip\_internal\resolution\resolvelib\resolver.py", "Python", 0, 0, 0, -238, 0, -34, -46, -318
"c:\Users\edwar\OneDrive\Documents\Programming\Visual Studio 2022\PARTS_Web\app\bot_env\Lib\site-packages\pip\_internal\self_outdated_check.py", "Python", 0, 0, 0, -185, 0, -16, -48, -249
"c:\Users\edwar\OneDrive\Documents\Programming\Visual Studio 2022\PARTS_Web\app\bot_env\Lib\site-packages\pip\_internal\utils\__init__.py", "Python", 0, 0, 0, 0, 0, 0, -1, -1
"c:\Users\edwar\OneDrive\Documents\Programming\Visual Studio 2022\PARTS_Web\app\bot_env\Lib\site-packages\pip\_internal\utils\_jaraco_text.py", "Python", 0, 0, 0, -83, 0, 0, -27, -110
"c:\Users\edwar\OneDrive\Documents\Programming\Visual Studio 2022\PARTS_Web\app\bot_env\Lib\site-packages\pip\_internal\utils\_log.py", "Python", 0, 0, 0, -23, 0, -2, -14, -39
"c:\Users\edwar\OneDrive\Documents\Programming\Visual Studio 2022\PARTS_Web\app\bot_env\Lib\site-packages\pip\_internal\utils\appdirs.py", "Python", 0, 0, 0, -31, 0, -5, -17, -53
"c:\Users\edwar\OneDrive\Documents\Programming\Visual Studio 2022\PARTS_Web\app\bot_env\Lib\site-packages\pip\_internal\utils\compat.py", "Python", 0, 0, 0, -36, 0, -9, -19, -64
"c:\Users\edwar\OneDrive\Documents\Programming\Visual Studio 2022\PARTS_Web\app\bot_env\Lib\site-packages\pip\_internal\utils\compatibility_tags.py", "Python", 0, 0, 0, -121, 0, -16, -29, -166
"c:\Users\edwar\OneDrive\Documents\Programming\Visual Studio 2022\PARTS_Web\app\bot_env\Lib\site-packages\pip\_internal\utils\datetime.py", "Python", 0, 0, 0, -7, 0, 0, -5, -12
"c:\Users\edwar\OneDrive\Documents\Programming\Visual Studio 2022\PARTS_Web\app\bot_env\Lib\site-packages\pip\_internal\utils\deprecation.py", "Python", 0, 0, 0, -92, 0, -6, -23, -121
"c:\Users\edwar\OneDrive\Documents\Programming\Visual Studio 2022\PARTS_Web\app\bot_env\Lib\site-packages\pip\_internal\utils\direct_url_helpers.py", "Python", 0, 0, 0, -71, 0, -9, -8, -88
"c:\Users\edwar\OneDrive\Documents\Programming\Visual Studio 2022\PARTS_Web\app\bot_env\Lib\site-packages\pip\_internal\utils\egg_link.py", "Python", 0, 0, 0, -67, 0, 0, -14, -81
"c:\Users\edwar\OneDrive\Documents\Programming\Visual Studio 2022\PARTS_Web\app\bot_env\Lib\site-packages\pip\_internal\utils\encoding.py", "Python", 0, 0, 0, -30, 0, -1, -6, -37
"c:\Users\edwar\OneDrive\Documents\Programming\Visual Studio 2022\PARTS_Web\app\bot_env\Lib\site-packages\pip\_internal\utils\entrypoints.py", "Python", 0, 0, 0, -65, 0, -5, -15, -85
"c:\Users\edwar\OneDrive\Documents\Programming\Visual Studio 2022\PARTS_Web\app\bot_env\Lib\site-packages\pip\_internal\utils\filesystem.py", "Python", 0, 0, 0, -104, 0, -18, -32, -154
"c:\Users\edwar\OneDrive\Documents\Programming\Visual Studio 2022\PARTS_Web\app\bot_env\Lib\site-packages\pip\_internal\utils\filetypes.py", "Python", 0, 0, 0, -22, 0, 0, -6, -28
"c:\Users\edwar\OneDrive\Documents\Programming\Visual Studio 2022\PARTS_Web\app\bot_env\Lib\site-packages\pip\_internal\utils\glibc.py", "Python", 0, 0, 0, -44, 0, -31, -14, -89
"c:\Users\edwar\OneDrive\Documents\Programming\Visual Studio 2022\PARTS_Web\app\bot_env\Lib\site-packages\pip\_internal\utils\hashes.py", "Python", 0, 0, 0, -103, 0, -12, -37, -152
"c:\Users\edwar\OneDrive\Documents\Programming\Visual Studio 2022\PARTS_Web\app\bot_env\Lib\site-packages\pip\_internal\utils\logging.py", "Python", 0, 0, 0, -273, 0, -22, -54, -349
"c:\Users\edwar\OneDrive\Documents\Programming\Visual Studio 2022\PARTS_Web\app\bot_env\Lib\site-packages\pip\_internal\utils\misc.py", "Python", 0, 0, 0, -597, 0, -28, -159, -784
"c:\Users\edwar\OneDrive\Documents\Programming\Visual Studio 2022\PARTS_Web\app\bot_env\Lib\site-packages\pip\_internal\utils\models.py", "Python", 0, 0, 0, -26, 0, 0, -14, -40
"c:\Users\edwar\OneDrive\Documents\Programming\Visual Studio 2022\PARTS_Web\app\bot_env\Lib\site-packages\pip\_internal\utils\packaging.py", "Python", 0, 0, 0, -36, 0, -6, -16, -58
"c:\Users\edwar\OneDrive\Documents\Programming\Visual Studio 2022\PARTS_Web\app\bot_env\Lib\site-packages\pip\_internal\utils\setuptools_build.py", "Python", 0, 0, 0, -106, 0, -16, -25, -147
"c:\Users\edwar\OneDrive\Documents\Programming\Visual Studio 2022\PARTS_Web\app\bot_env\Lib\site-packages\pip\_internal\utils\subprocess.py", "Python", 0, 0, 0, -197, 0, -39, -25, -261
"c:\Users\edwar\OneDrive\Documents\Programming\Visual Studio 2022\PARTS_Web\app\bot_env\Lib\site-packages\pip\_internal\utils\temp_dir.py", "Python", 0, 0, 0, -220, 0, -22, -55, -297
"c:\Users\edwar\OneDrive\Documents\Programming\Visual Studio 2022\PARTS_Web\app\bot_env\Lib\site-packages\pip\_internal\utils\unpacking.py", "Python", 0, 0, 0, -215, 0, -14, -29, -258
"c:\Users\edwar\OneDrive\Documents\Programming\Visual Studio 2022\PARTS_Web\app\bot_env\Lib\site-packages\pip\_internal\utils\urls.py", "Python", 0, 0, 0, -45, 0, -5, -13, -63
"c:\Users\edwar\OneDrive\Documents\Programming\Visual Studio 2022\PARTS_Web\app\bot_env\Lib\site-packages\pip\_internal\utils\virtualenv.py", "Python", 0, 0, 0, -72, 0, -7, -26, -105
"c:\Users\edwar\OneDrive\Documents\Programming\Visual Studio 2022\PARTS_Web\app\bot_env\Lib\site-packages\pip\_internal\utils\wheel.py", "Python", 0, 0, 0, -92, 0, -7, -36, -135
"c:\Users\edwar\OneDrive\Documents\Programming\Visual Studio 2022\PARTS_Web\app\bot_env\Lib\site-packages\pip\_internal\vcs\__init__.py", "Python", 0, 0, 0, -11, 0, -4, -1, -16
"c:\Users\edwar\OneDrive\Documents\Programming\Visual Studio 2022\PARTS_Web\app\bot_env\Lib\site-packages\pip\_internal\vcs\bazaar.py", "Python", 0, 0, 0, -94, 0, -3, -16, -113
"c:\Users\edwar\OneDrive\Documents\Programming\Visual Studio 2022\PARTS_Web\app\bot_env\Lib\site-packages\pip\_internal\vcs\git.py", "Python", 0, 0, 0, -402, 0, -56, -69, -527
"c:\Users\edwar\OneDrive\Documents\Programming\Visual Studio 2022\PARTS_Web\app\bot_env\Lib\site-packages\pip\_internal\vcs\mercurial.py", "Python", 0, 0, 0, -146, 0, -1, -17, -164
"c:\Users\edwar\OneDrive\Documents\Programming\Visual Studio 2022\PARTS_Web\app\bot_env\Lib\site-packages\pip\_internal\vcs\subversion.py", "Python", 0, 0, 0, -237, 0, -40, -48, -325
"c:\Users\edwar\OneDrive\Documents\Programming\Visual Studio 2022\PARTS_Web\app\bot_env\Lib\site-packages\pip\_internal\vcs\versioncontrol.py", "Python", 0, 0, 0, -570, 0, -23, -113, -706
"c:\Users\edwar\OneDrive\Documents\Programming\Visual Studio 2022\PARTS_Web\app\bot_env\Lib\site-packages\pip\_internal\wheel_builder.py", "Python", 0, 0, 0, -290, 0, -19, -46, -355
"c:\Users\edwar\OneDrive\Documents\Programming\Visual Studio 2022\PARTS_Web\app\bot_env\Lib\site-packages\pip\_vendor\__init__.py", "Python", 0, 0, 0, -85, 0, -26, -11, -122
"c:\Users\edwar\OneDrive\Documents\Programming\Visual Studio 2022\PARTS_Web\app\bot_env\Lib\site-packages\pip\_vendor\cachecontrol\__init__.py", "Python", 0, 0, 0, -19, 0, -3, -7, -29
"c:\Users\edwar\OneDrive\Documents\Programming\Visual Studio 2022\PARTS_Web\app\bot_env\Lib\site-packages\pip\_vendor\cachecontrol\_cmd.py", "Python", 0, 0, 0, -43, 0, -7, -21, -71
"c:\Users\edwar\OneDrive\Documents\Programming\Visual Studio 2022\PARTS_Web\app\bot_env\Lib\site-packages\pip\_vendor\cachecontrol\adapter.py", "Python", 0, 0, 0, -114, 0, -20, -28, -162
"c:\Users\edwar\OneDrive\Documents\Programming\Visual Studio 2022\PARTS_Web\app\bot_env\Lib\site-packages\pip\_vendor\cachecontrol\cache.py", "Python", 0, 0, 0, -51, 0, -3, -21, -75
"c:\Users\edwar\OneDrive\Documents\Programming\Visual Studio 2022\PARTS_Web\app\bot_env\Lib\site-packages\pip\_vendor\cachecontrol\caches\__init__.py", "Python", 0, 0, 0, -3, 0, -3, -3, -9
"c:\Users\edwar\OneDrive\Documents\Programming\Visual Studio 2022\PARTS_Web\app\bot_env\Lib\site-packages\pip\_vendor\cachecontrol\caches\file_cache.py", "Python", 0, 0, 0, -122, 0, -23, -37, -182
"c:\Users\edwar\OneDrive\Documents\Programming\Visual Studio 2022\PARTS_Web\app\bot_env\Lib\site-packages\pip\_vendor\cachecontrol\caches\redis_cache.py", "Python", 0, 0, 0, -34, 0, -3, -12, -49
"c:\Users\edwar\OneDrive\Documents\Programming\Visual Studio 2022\PARTS_Web\app\bot_env\Lib\site-packages\pip\_vendor\cachecontrol\controller.py", "Python", 0, 0, 0, -348, 0, -67, -80, -495
"c:\Users\edwar\OneDrive\Documents\Programming\Visual Studio 2022\PARTS_Web\app\bot_env\Lib\site-packages\pip\_vendor\cachecontrol\filewrapper.py", "Python", 0, 0, 0, -68, 0, -29, -23, -120
"c:\Users\edwar\OneDrive\Documents\Programming\Visual Studio 2022\PARTS_Web\app\bot_env\Lib\site-packages\pip\_vendor\cachecontrol\heuristics.py", "Python", 0, 0, 0, -114, 0, -3, -38, -155
"c:\Users\edwar\OneDrive\Documents\Programming\Visual Studio 2022\PARTS_Web\app\bot_env\Lib\site-packages\pip\_vendor\cachecontrol\serialize.py", "Python", 0, 0, 0, -135, 0, -40, -32, -207
"c:\Users\edwar\OneDrive\Documents\Programming\Visual Studio 2022\PARTS_Web\app\bot_env\Lib\site-packages\pip\_vendor\cachecontrol\wrapper.py", "Python", 0, 0, 0, -33, 0, -3, -8, -44
"c:\Users\edwar\OneDrive\Documents\Programming\Visual Studio 2022\PARTS_Web\app\bot_env\Lib\site-packages\pip\_vendor\certifi\__init__.py", "Python", 0, 0, 0, -3, 0, 0, -2, -5
"c:\Users\edwar\OneDrive\Documents\Programming\Visual Studio 2022\PARTS_Web\app\bot_env\Lib\site-packages\pip\_vendor\certifi\__main__.py", "Python", 0, 0, 0, -9, 0, 0, -4, -13
"c:\Users\edwar\OneDrive\Documents\Programming\Visual Studio 2022\PARTS_Web\app\bot_env\Lib\site-packages\pip\_vendor\certifi\core.py", "Python", 0, 0, 0, -51, 0, -37, -21, -109
"c:\Users\edwar\OneDrive\Documents\Programming\Visual Studio 2022\PARTS_Web\app\bot_env\Lib\site-packages\pip\_vendor\chardet\__init__.py", "Python", 0, 0, 0, -84, 0, -19, -13, -116
"c:\Users\edwar\OneDrive\Documents\Programming\Visual Studio 2022\PARTS_Web\app\bot_env\Lib\site-packages\pip\_vendor\chardet\big5freq.py", "Python", 0, 0, 0, -340, 0, -43, -4, -387
"c:\Users\edwar\OneDrive\Documents\Programming\Visual Studio 2022\PARTS_Web\app\bot_env\Lib\site-packages\pip\_vendor\chardet\big5prober.py", "Python", 0, 0, 0, -16, 0, -26, -6, -48
"c:\Users\edwar\OneDrive\Documents\Programming\Visual Studio 2022\PARTS_Web\app\bot_env\Lib\site-packages\pip\_vendor\chardet\chardistribution.py", "Python", 0, 0, 0, -158, 0, -70, -34, -262
"c:\Users\edwar\OneDrive\Documents\Programming\Visual Studio 2022\PARTS_Web\app\bot_env\Lib\site-packages\pip\_vendor\chardet\charsetgroupprober.py", "Python", 0, 0, 0, -71, 0, -26, -10, -107
"c:\Users\edwar\OneDrive\Documents\Programming\Visual Studio 2022\PARTS_Web\app\bot_env\Lib\site-packages\pip\_vendor\chardet\charsetprober.py", "Python", 0, 0, 0, -80, 0, -43, -25, -148
"c:\Users\edwar\OneDrive\Documents\Programming\Visual Studio 2022\PARTS_Web\app\bot_env\Lib\site-packages\pip\_vendor\chardet\cli\__init__.py", "Python", 0, 0, 0, 0, 0, 0, -1, -1
"c:\Users\edwar\OneDrive\Documents\Programming\Visual Studio 2022\PARTS_Web\app\bot_env\Lib\site-packages\pip\_vendor\chardet\cli\chardetect.py", "Python", 0, 0, 0, -94, 0, -2, -17, -113
"c:\Users\edwar\OneDrive\Documents\Programming\Visual Studio 2022\PARTS_Web\app\bot_env\Lib\site-packages\pip\_vendor\chardet\codingstatemachine.py", "Python", 0, 0, 0, -48, 0, -29, -14, -91
"c:\Users\edwar\OneDrive\Documents\Programming\Visual Studio 2022\PARTS_Web\app\bot_env\Lib\site-packages\pip\_vendor\chardet\codingstatemachinedict.py", "Python", 0, 0, 0, -12, 0, -4, -4, -20
"c:\Users\edwar\OneDrive\Documents\Programming\Visual Studio 2022\PARTS_Web\app\bot_env\Lib\site-packages\pip\_vendor\chardet\cp949prober.py", "Python", 0, 0, 0, -16, 0, -28, -6, -50
"c:\Users\edwar\OneDrive\Documents\Programming\Visual Studio 2022\PARTS_Web\app\bot_env\Lib\site-packages\pip\_vendor\chardet\enums.py", "Python", 0, 0, 0, -63, 0, 0, -23, -86
"c:\Users\edwar\OneDrive\Documents\Programming\Visual Studio 2022\PARTS_Web\app\bot_env\Lib\site-packages\pip\_vendor\chardet\escprober.py", "Python", 0, 0, 0, -65, 0, -26, -12, -103
"c:\Users\edwar\OneDrive\Documents\Programming\Visual Studio 2022\PARTS_Web\app\bot_env\Lib\site-packages\pip\_vendor\chardet\escsm.py", "Python", 0, 0, 0, -210, 0, -34, -18, -262
"c:\Users\edwar\OneDrive\Documents\Programming\Visual Studio 2022\PARTS_Web\app\bot_env\Lib\site-packages\pip\_vendor\chardet\eucjpprober.py", "Python", 0, 0, 0, -61, 0, -27, -15, -103
"c:\Users\edwar\OneDrive\Documents\Programming\Visual Studio 2022\PARTS_Web\app\bot_env\Lib\site-packages\pip\_vendor\chardet\euckrfreq.py", "Python", 0, 0, 0, -151, 0, -40, -6, -197
"c:\Users\edwar\OneDrive\Documents\Programming\Visual Studio 2022\PARTS_Web\app\bot_env\Lib\site-packages\pip\_vendor\chardet\euckrprober.py", "Python", 0, 0, 0, -16, 0, -26, -6, -48
"c:\Users\edwar\OneDrive\Documents\Programming\Visual Studio 2022\PARTS_Web\app\bot_env\Lib\site-packages\pip\_vendor\chardet\euctwfreq.py", "Python", 0, 0, 0, -340, 0, -43, -6, -389
"c:\Users\edwar\OneDrive\Documents\Programming\Visual Studio 2022\PARTS_Web\app\bot_env\Lib\site-packages\pip\_vendor\chardet\euctwprober.py", "Python", 0, 0, 0, -16, 0, -26, -6, -48
"c:\Users\edwar\OneDrive\Documents\Programming\Visual Studio 2022\PARTS_Web\app\bot_env\Lib\site-packages\pip\_vendor\chardet\gb2312freq.py", "Python", 0, 0, 0, -239, 0, -40, -6, -285
"c:\Users\edwar\OneDrive\Documents\Programming\Visual Studio 2022\PARTS_Web\app\bot_env\Lib\site-packages\pip\_vendor\chardet\gb2312prober.py", "Python", 0, 0, 0, -16, 0, -26, -6, -48
"c:\Users\edwar\OneDrive\Documents\Programming\Visual Studio 2022\PARTS_Web\app\bot_env\Lib\site-packages\pip\_vendor\chardet\hebrewprober.py", "Python", 0, 0, 0, -103, 0, -186, -28, -317
"c:\Users\edwar\OneDrive\Documents\Programming\Visual Studio 2022\PARTS_Web\app\bot_env\Lib\site-packages\pip\_vendor\chardet\jisfreq.py", "Python", 0, 0, 0, -277, 0, -43, -6, -326
"c:\Users\edwar\OneDrive\Documents\Programming\Visual Studio 2022\PARTS_Web\app\bot_env\Lib\site-packages\pip\_vendor\chardet\johabfreq.py", "Python", 0, 0, 0, -2352, 0, -28, -3, -2383
"c:\Users\edwar\OneDrive\Documents\Programming\Visual Studio 2022\PARTS_Web\app\bot_env\Lib\site-packages\pip\_vendor\chardet\johabprober.py", "Python", 0, 0, 0, -16, 0, -26, -6, -48
"c:\Users\edwar\OneDrive\Documents\Programming\Visual Studio 2022\PARTS_Web\app\bot_env\Lib\site-packages\pip\_vendor\chardet\jpcntx.py", "Python", 0, 0, 0, -171, 0, -46, -22, -239
"c:\Users\edwar\OneDrive\Documents\Programming\Visual Studio 2022\PARTS_Web\app\bot_env\Lib\site-packages\pip\_vendor\chardet\langbulgarianmodel.py", "Python", 0, 0, 0, -4632, 0, -10, -8, -4650
"c:\Users\edwar\OneDrive\Documents\Programming\Visual Studio 2022\PARTS_Web\app\bot_env\Lib\site-packages\pip\_vendor\chardet\langgreekmodel.py", "Python", 0, 0, 0, -4380, 0, -10, -8, -4398
"c:\Users\edwar\OneDrive\Documents\Programming\Visual Studio 2022\PARTS_Web\app\bot_env\Lib\site-packages\pip\_vendor\chardet\langhebrewmodel.py", "Python", 0, 0, 0, -4365, 0, -10, -6, -4381
"c:\Users\edwar\OneDrive\Documents\Programming\Visual Studio 2022\PARTS_Web\app\bot_env\Lib\site-packages\pip\_vendor\chardet\langhungarianmodel.py", "Python", 0, 0, 0, -4632, 0, -10, -8, -4650
"c:\Users\edwar\OneDrive\Documents\Programming\Visual Studio 2022\PARTS_Web\app\bot_env\Lib\site-packages\pip\_vendor\chardet\langrussianmodel.py", "Python", 0, 0, 0, -5700, 0, -10, -16, -5726
"c:\Users\edwar\OneDrive\Documents\Programming\Visual Studio 2022\PARTS_Web\app\bot_env\Lib\site-packages\pip\_vendor\chardet\langthaimodel.py", "Python", 0, 0, 0, -4365, 0, -10, -6, -4381
"c:\Users\edwar\OneDrive\Documents\Programming\Visual Studio 2022\PARTS_Web\app\bot_env\Lib\site-packages\pip\_vendor\chardet\langturkishmodel.py", "Python", 0, 0, 0, -4365, 0, -10, -6, -4381
"c:\Users\edwar\OneDrive\Documents\Programming\Visual Studio 2022\PARTS_Web\app\bot_env\Lib\site-packages\pip\_vendor\chardet\latin1prober.py", "Python", 0, 0, 0, -96, 0, -36, -16, -148
"c:\Users\edwar\OneDrive\Documents\Programming\Visual Studio 2022\PARTS_Web\app\bot_env\Lib\site-packages\pip\_vendor\chardet\macromanprober.py", "Python", 0, 0, 0, -99, 0, -45, -19, -163
"c:\Users\edwar\OneDrive\Documents\Programming\Visual Studio 2022\PARTS_Web\app\bot_env\Lib\site-packages\pip\_vendor\chardet\mbcharsetprober.py", "Python", 0, 0, 0, -55, 0, -28, -13, -96
"c:\Users\edwar\OneDrive\Documents\Programming\Visual Studio 2022\PARTS_Web\app\bot_env\Lib\site-packages\pip\_vendor\chardet\mbcsgroupprober.py", "Python", 0, 0, 0, -26, 0, -28, -4, -58
"c:\Users\edwar\OneDrive\Documents\Programming\Visual Studio 2022\PARTS_Web\app\bot_env\Lib\site-packages\pip\_vendor\chardet\mbcssm.py", "Python", 0, 0, 0, -547, 0, -68, -47, -662
"c:\Users\edwar\OneDrive\Documents\Programming\Visual Studio 2022\PARTS_Web\app\bot_env\Lib\site-packages\pip\_vendor\chardet\metadata\__init__.py", "Python", 0, 0, 0, 0, 0, 0, -1, -1
"c:\Users\edwar\OneDrive\Documents\Programming\Visual Studio 2022\PARTS_Web\app\bot_env\Lib\site-packages\pip\_vendor\chardet\metadata\languages.py", "Python", 0, 0, 0, -308, 0, -34, -11, -353
"c:\Users\edwar\OneDrive\Documents\Programming\Visual Studio 2022\PARTS_Web\app\bot_env\Lib\site-packages\pip\_vendor\chardet\resultdict.py", "Python", 0, 0, 0, -9, 0, -4, -4, -17
"c:\Users\edwar\OneDrive\Documents\Programming\Visual Studio 2022\PARTS_Web\app\bot_env\Lib\site-packages\pip\_vendor\chardet\sbcharsetprober.py", "Python", 0, 0, 0, -108, 0, -40, -15, -163
"c:\Users\edwar\OneDrive\Documents\Programming\Visual Studio 2022\PARTS_Web\app\bot_env\Lib\site-packages\pip\_vendor\chardet\sbcsgroupprober.py", "Python", 0, 0, 0, -45, 0, -39, -5, -89
"c:\Users\edwar\OneDrive\Documents\Programming\Visual Studio 2022\PARTS_Web\app\bot_env\Lib\site-packages\pip\_vendor\chardet\sjisprober.py", "Python", 0, 0, 0, -65, 0, -26, -15, -106
"c:\Users\edwar\OneDrive\Documents\Programming\Visual Studio 2022\PARTS_Web\app\bot_env\Lib\site-packages\pip\_vendor\chardet\universaldetector.py", "Python", 0, 0, 0, -265, 0, -63, -35, -363
"c:\Users\edwar\OneDrive\Documents\Programming\Visual Studio 2022\PARTS_Web\app\bot_env\Lib\site-packages\pip\_vendor\chardet\utf1632prober.py", "Python", 0, 0, 0, -175, 0, -26, -25, -226
"c:\Users\edwar\OneDrive\Documents\Programming\Visual Studio 2022\PARTS_Web\app\bot_env\Lib\site-packages\pip\_vendor\chardet\utf8prober.py", "Python", 0, 0, 0, -44, 0, -26, -13, -83
"c:\Users\edwar\OneDrive\Documents\Programming\Visual Studio 2022\PARTS_Web\app\bot_env\Lib\site-packages\pip\_vendor\chardet\version.py", "Python", 0, 0, 0, -7, 0, 0, -3, -10
"c:\Users\edwar\OneDrive\Documents\Programming\Visual Studio 2022\PARTS_Web\app\bot_env\Lib\site-packages\pip\_vendor\colorama\__init__.py", "Python", 0, 0, 0, -4, 0, -1, -3, -8
"c:\Users\edwar\OneDrive\Documents\Programming\Visual Studio 2022\PARTS_Web\app\bot_env\Lib\site-packages\pip\_vendor\colorama\ansi.py", "Python", 0, 0, 0, -77, 0, -6, -20, -103
"c:\Users\edwar\OneDrive\Documents\Programming\Visual Studio 2022\PARTS_Web\app\bot_env\Lib\site-packages\pip\_vendor\colorama\ansitowin32.py", "Python", 0, 0, 0, -209, 0, -25, -44, -278
"c:\Users\edwar\OneDrive\Documents\Programming\Visual Studio 2022\PARTS_Web\app\bot_env\Lib\site-packages\pip\_vendor\colorama\initialise.py", "Python", 0, 0, 0, -83, 0, -8, -31, -122
"c:\Users\edwar\OneDrive\Documents\Programming\Visual Studio 2022\PARTS_Web\app\bot_env\Lib\site-packages\pip\_vendor\colorama\tests\__init__.py", "Python", 0, 0, 0, 0, 0, -1, -1, -2
"c:\Users\edwar\OneDrive\Documents\Programming\Visual Studio 2022\PARTS_Web\app\bot_env\Lib\site-packages\pip\_vendor\colorama\tests\ansi_test.py", "Python", 0, 0, 0, -55, 0, -5, -17, -77
"c:\Users\edwar\OneDrive\Documents\Programming\Visual Studio 2022\PARTS_Web\app\bot_env\Lib\site-packages\pip\_vendor\colorama\tests\ansitowin32_test.py", "Python", 0, 0, 0, -243, 0, -8, -44, -295
"c:\Users\edwar\OneDrive\Documents\Programming\Visual Studio 2022\PARTS_Web\app\bot_env\Lib\site-packages\pip\_vendor\colorama\tests\initialise_test.py", "Python", 0, 0, 0, -145, 0, -10, -35, -190
"c:\Users\edwar\OneDrive\Documents\Programming\Visual Studio 2022\PARTS_Web\app\bot_env\Lib\site-packages\pip\_vendor\colorama\tests\isatty_test.py", "Python", 0, 0, 0, -43, 0, -1, -14, -58
"c:\Users\edwar\OneDrive\Documents\Programming\Visual Studio 2022\PARTS_Web\app\bot_env\Lib\site-packages\pip\_vendor\colorama\tests\utils.py", "Python", 0, 0, 0, -41, 0, -1, -8, -50
"c:\Users\edwar\OneDrive\Documents\Programming\Visual Studio 2022\PARTS_Web\app\bot_env\Lib\site-packages\pip\_vendor\colorama\tests\winterm_test.py", "Python", 0, 0, 0, -99, 0, -1, -32, -132
"c:\Users\edwar\OneDrive\Documents\Programming\Visual Studio 2022\PARTS_Web\app\bot_env\Lib\site-packages\pip\_vendor\colorama\win32.py", "Python", 0, 0, 0, -146, 0, -10, -25, -181
"c:\Users\edwar\OneDrive\Documents\Programming\Visual Studio 2022\PARTS_Web\app\bot_env\Lib\site-packages\pip\_vendor\colorama\winterm.py", "Python", 0, 0, 0, -143, 0, -29, -24, -196
"c:\Users\edwar\OneDrive\Documents\Programming\Visual Studio 2022\PARTS_Web\app\bot_env\Lib\site-packages\pip\_vendor\distlib\__init__.py", "Python", 0, 0, 0, -16, 0, -6, -12, -34
"c:\Users\edwar\OneDrive\Documents\Programming\Visual Studio 2022\PARTS_Web\app\bot_env\Lib\site-packages\pip\_vendor\distlib\compat.py", "Python", 0, 0, 0, -861, 0, -101, -177, -1139
"c:\Users\edwar\OneDrive\Documents\Programming\Visual Studio 2022\PARTS_Web\app\bot_env\Lib\site-packages\pip\_vendor\distlib\database.py", "Python", 0, 0, 0, -1135, 0, -45, -180, -1360
"c:\Users\edwar\OneDrive\Documents\Programming\Visual Studio 2022\PARTS_Web\app\bot_env\Lib\site-packages\pip\_vendor\distlib\index.py", "Python", 0, 0, 0, -445, 0, -19, -45, -509
"c:\Users\edwar\OneDrive\Documents\Programming\Visual Studio 2022\PARTS_Web\app\bot_env\Lib\site-packages\pip\_vendor\distlib\locators.py", "Python", 0, 0, 0, -1107, 0, -77, -120, -1304
"c:\Users\edwar\OneDrive\Documents\Programming\Visual Studio 2022\PARTS_Web\app\bot_env\Lib\site-packages\pip\_vendor\distlib\manifest.py", "Python", 0, 0, 0, -276, 0, -40, -69, -385
"c:\Users\edwar\OneDrive\Documents\Programming\Visual Studio 2022\PARTS_Web\app\bot_env\Lib\site-packages\pip\_vendor\distlib\markers.py", "Python", 0, 0, 0, -129, 0, -9, -30, -168
"c:\Users\edwar\OneDrive\Documents\Programming\Visual Studio 2022\PARTS_Web\app\bot_env\Lib\site-packages\pip\_vendor\distlib\metadata.py", "Python", 0, 0, 0, -840, 0, -74, -155, -1069
"c:\Users\edwar\OneDrive\Documents\Programming\Visual Studio 2022\PARTS_Web\app\bot_env\Lib\site-packages\pip\_vendor\distlib\resources.py", "Python", 0, 0, 0, -280, 0, -15, -64, -359
"c:\Users\edwar\OneDrive\Documents\Programming\Visual Studio 2022\PARTS_Web\app\bot_env\Lib\site-packages\pip\_vendor\distlib\scripts.py", "Python", 0, 0, 0, -359, 0, -48, -46, -453
"c:\Users\edwar\OneDrive\Documents\Programming\Visual Studio 2022\PARTS_Web\app\bot_env\Lib\site-packages\pip\_vendor\distlib\util.py", "Python", 0, 0, 0, -1564, 0, -167, -295, -2026
"c:\Users\edwar\OneDrive\Documents\Programming\Visual Studio 2022\PARTS_Web\app\bot_env\Lib\site-packages\pip\_vendor\distlib\version.py", "Python", 0, 0, 0, -533, 0, -86, -133, -752
"c:\Users\edwar\OneDrive\Documents\Programming\Visual Studio 2022\PARTS_Web\app\bot_env\Lib\site-packages\pip\_vendor\distlib\wheel.py", "Python", 0, 0, 0, -902, 0, -81, -117, -1100
"c:\Users\edwar\OneDrive\Documents\Programming\Visual Studio 2022\PARTS_Web\app\bot_env\Lib\site-packages\pip\_vendor\distro\__init__.py", "Python", 0, 0, 0, -52, 0, 0, -3, -55
"c:\Users\edwar\OneDrive\Documents\Programming\Visual Studio 2022\PARTS_Web\app\bot_env\Lib\site-packages\pip\_vendor\distro\__main__.py", "Python", 0, 0, 0, -3, 0, 0, -2, -5
"c:\Users\edwar\OneDrive\Documents\Programming\Visual Studio 2022\PARTS_Web\app\bot_env\Lib\site-packages\pip\_vendor\distro\distro.py", "Python", 0, 0, 0, -1035, 0, -90, -275, -1400
"c:\Users\edwar\OneDrive\Documents\Programming\Visual Studio 2022\PARTS_Web\app\bot_env\Lib\site-packages\pip\_vendor\idna\__init__.py", "Python", 0, 0, 0, -43, 0, 0, -2, -45
"c:\Users\edwar\OneDrive\Documents\Programming\Visual Studio 2022\PARTS_Web\app\bot_env\Lib\site-packages\pip\_vendor\idna\codec.py", "Python", 0, 0, 0, -84, 0, -4, -25, -113
"c:\Users\edwar\OneDrive\Documents\Programming\Visual Studio 2022\PARTS_Web\app\bot_env\Lib\site-packages\pip\_vendor\idna\compat.py", "Python", 0, 0, 0, -9, 0, 0, -5, -14
"c:\Users\edwar\OneDrive\Documents\Programming\Visual Studio 2022\PARTS_Web\app\bot_env\Lib\site-packages\pip\_vendor\idna\core.py", "Python", 0, 0, 0, -319, 0, -8, -74, -401
"c:\Users\edwar\OneDrive\Documents\Programming\Visual Studio 2022\PARTS_Web\app\bot_env\Lib\site-packages\pip\_vendor\idna\idnadata.py", "Python", 0, 0, 0, -2149, 0, -1, -2, -2152
"c:\Users\edwar\OneDrive\Documents\Programming\Visual Studio 2022\PARTS_Web\app\bot_env\Lib\site-packages\pip\_vendor\idna\intranges.py", "Python", 0, 0, 0, -42, 0, -3, -10, -55
"c:\Users\edwar\OneDrive\Documents\Programming\Visual Studio 2022\PARTS_Web\app\bot_env\Lib\site-packages\pip\_vendor\idna\package_data.py", "Python", 0, 0, 0, -1, 0, 0, -2, -3
"c:\Users\edwar\OneDrive\Documents\Programming\Visual Studio 2022\PARTS_Web\app\bot_env\Lib\site-packages\pip\_vendor\idna\uts46data.py", "Python", 0, 0, 0, -8511, 0, -2, -88, -8601
"c:\Users\edwar\OneDrive\Documents\Programming\Visual Studio 2022\PARTS_Web\app\bot_env\Lib\site-packages\pip\_vendor\msgpack\__init__.py", "Python", 0, 0, 0, -38, 0, -2, -18, -58
"c:\Users\edwar\OneDrive\Documents\Programming\Visual Studio 2022\PARTS_Web\app\bot_env\Lib\site-packages\pip\_vendor\msgpack\exceptions.py", "Python", 0, 0, 0, -28, 0, -2, -19, -49
"c:\Users\edwar\OneDrive\Documents\Programming\Visual Studio 2022\PARTS_Web\app\bot_env\Lib\site-packages\pip\_vendor\msgpack\ext.py", "Python", 0, 0, 0, -149, 0, -4, -41, -194
"c:\Users\edwar\OneDrive\Documents\Programming\Visual Studio 2022\PARTS_Web\app\bot_env\Lib\site-packages\pip\_vendor\msgpack\fallback.py", "Python", 0, 0, 0, -857, 0, -22, -132, -1011
"c:\Users\edwar\OneDrive\Documents\Programming\Visual Studio 2022\PARTS_Web\app\bot_env\Lib\site-packages\pip\_vendor\packaging\__about__.py", "Python", 0, 0, 0, -18, 0, -3, -6, -27
"c:\Users\edwar\OneDrive\Documents\Programming\Visual Studio 2022\PARTS_Web\app\bot_env\Lib\site-packages\pip\_vendor\packaging\__init__.py", "Python", 0, 0, 0, -20, 0, -3, -3, -26
"c:\Users\edwar\OneDrive\Documents\Programming\Visual Studio 2022\PARTS_Web\app\bot_env\Lib\site-packages\pip\_vendor\packaging\_manylinux.py", "Python", 0, 0, 0, -212, 0, -51, -39, -302
"c:\Users\edwar\OneDrive\Documents\Programming\Visual Studio 2022\PARTS_Web\app\bot_env\Lib\site-packages\pip\_vendor\packaging\_musllinux.py", "Python", 0, 0, 0, -107, 0, -4, -26, -137
"c:\Users\edwar\OneDrive\Documents\Programming\Visual Studio 2022\PARTS_Web\app\bot_env\Lib\site-packages\pip\_vendor\packaging\_structures.py", "Python", 0, 0, 0, -36, 0, -3, -23, -62
"c:\Users\edwar\OneDrive\Documents\Programming\Visual Studio 2022\PARTS_Web\app\bot_env\Lib\site-packages\pip\_vendor\packaging\markers.py", "Python", 0, 0, 0, -224, 0, -7, -74, -305
"c:\Users\edwar\OneDrive\Documents\Programming\Visual Studio 2022\PARTS_Web\app\bot_env\Lib\site-packages\pip\_vendor\packaging\requirements.py", "Python", 0, 0, 0, -105, 0, -9, -33, -147
"c:\Users\edwar\OneDrive\Documents\Programming\Visual Studio 2022\PARTS_Web\app\bot_env\Lib\site-packages\pip\_vendor\packaging\specifiers.py", "Python", 0, 0, 0, -490, 0, -156, -157, -803
"c:\Users\edwar\OneDrive\Documents\Programming\Visual Studio 2022\PARTS_Web\app\bot_env\Lib\site-packages\pip\_vendor\packaging\tags.py", "Python", 0, 0, 0, -373, 0, -26, -89, -488
"c:\Users\edwar\OneDrive\Documents\Programming\Visual Studio 2022\PARTS_Web\app\bot_env\Lib\site-packages\pip\_vendor\packaging\utils.py", "Python", 0, 0, 0, -91, 0, -16, -30, -137
"c:\Users\edwar\OneDrive\Documents\Programming\Visual Studio 2022\PARTS_Web\app\bot_env\Lib\site-packages\pip\_vendor\packaging\version.py", "Python", 0, 0, 0, -334, 0, -58, -113, -505
"c:\Users\edwar\OneDrive\Documents\Programming\Visual Studio 2022\PARTS_Web\app\bot_env\Lib\site-packages\pip\_vendor\pkg_resources\__init__.py", "Python", 0, 0, 0, -2548, 0, -154, -660, -3362
"c:\Users\edwar\OneDrive\Documents\Programming\Visual Studio 2022\PARTS_Web\app\bot_env\Lib\site-packages\pip\_vendor\platformdirs\__init__.py", "Python", 0, 0, 0, -495, 0, 0, -72, -567
"c:\Users\edwar\OneDrive\Documents\Programming\Visual Studio 2022\PARTS_Web\app\bot_env\Lib\site-packages\pip\_vendor\platformdirs\__main__.py", "Python", 0, 0, 0, -42, 0, 0, -12, -54
"c:\Users\edwar\OneDrive\Documents\Programming\Visual Studio 2022\PARTS_Web\app\bot_env\Lib\site-packages\pip\_vendor\platformdirs\android.py", "Python", 0, 0, 0, -160, 0, -7, -44, -211
"c:\Users\edwar\OneDrive\Documents\Programming\Visual Studio 2022\PARTS_Web\app\bot_env\Lib\site-packages\pip\_vendor\platformdirs\api.py", "Python", 0, 0, 0, -186, 0, 0, -38, -224
"c:\Users\edwar\OneDrive\Documents\Programming\Visual Studio 2022\PARTS_Web\app\bot_env\Lib\site-packages\pip\_vendor\platformdirs\macos.py", "Python", 0, 0, 0, -71, 0, 0, -21, -92
"c:\Users\edwar\OneDrive\Documents\Programming\Visual Studio 2022\PARTS_Web\app\bot_env\Lib\site-packages\pip\_vendor\platformdirs\unix.py", "Python", 0, 0, 0, -180, 0, -5, -39, -224
"c:\Users\edwar\OneDrive\Documents\Programming\Visual Studio 2022\PARTS_Web\app\bot_env\Lib\site-packages\pip\_vendor\platformdirs\version.py", "Python", 0, 0, 0, -2, 0, -2, -1, -5
"c:\Users\edwar\OneDrive\Documents\Programming\Visual Studio 2022\PARTS_Web\app\bot_env\Lib\site-packages\pip\_vendor\platformdirs\windows.py", "Python", 0, 0, 0, -206, 0, -4, -46, -256
"c:\Users\edwar\OneDrive\Documents\Programming\Visual Studio 2022\PARTS_Web\app\bot_env\Lib\site-packages\pip\_vendor\pygments\__init__.py", "Python", 0, 0, 0, -65, 0, -2, -16, -83
"c:\Users\edwar\OneDrive\Documents\Programming\Visual Studio 2022\PARTS_Web\app\bot_env\Lib\site-packages\pip\_vendor\pygments\__main__.py", "Python", 0, 0, 0, -13, 0, 0, -5, -18
"c:\Users\edwar\OneDrive\Documents\Programming\Visual Studio 2022\PARTS_Web\app\bot_env\Lib\site-packages\pip\_vendor\pygments\cmdline.py", "Python", 0, 0, 0, -554, 0, -39, -76, -669
"c:\Users\edwar\OneDrive\Documents\Programming\Visual Studio 2022\PARTS_Web\app\bot_env\Lib\site-packages\pip\_vendor\pygments\console.py", "Python", 0, 0, 0, -54, 0, 0, -17, -71
"c:\Users\edwar\OneDrive\Documents\Programming\Visual Studio 2022\PARTS_Web\app\bot_env\Lib\site-packages\pip\_vendor\pygments\filter.py", "Python", 0, 0, 0, -55, 0, -1, -16, -72
"c:\Users\edwar\OneDrive\Documents\Programming\Visual Studio 2022\PARTS_Web\app\bot_env\Lib\site-packages\pip\_vendor\pygments\filters\__init__.py", "Python", 0, 0, 0, -858, 0, -3, -80, -941
"c:\Users\edwar\OneDrive\Documents\Programming\Visual Studio 2022\PARTS_Web\app\bot_env\Lib\site-packages\pip\_vendor\pygments\formatter.py", "Python", 0, 0, 0, -88, 0, -10, -27, -125
"c:\Users\edwar\OneDrive\Documents\Programming\Visual Studio 2022\PARTS_Web\app\bot_env\Lib\site-packages\pip\_vendor\pygments\formatters\__init__.py", "Python", 0, 0, 0, -123, 0, -4, -32, -159
"c:\Users\edwar\OneDrive\Documents\Programming\Visual Studio 2022\PARTS_Web\app\bot_env\Lib\site-packages\pip\_vendor\pygments\formatters\_mapping.py", "Python", 0, 0, 0, -20, 0, -2, -2, -24
"c:\Users\edwar\OneDrive\Documents\Programming\Visual Studio 2022\PARTS_Web\app\bot_env\Lib\site-packages\pip\_vendor\pygments\formatters\bbcode.py", "Python", 0, 0, 0, -85, 0, -1, -23, -109
"c:\Users\edwar\OneDrive\Documents\Programming\Visual Studio 2022\PARTS_Web\app\bot_env\Lib\site-packages\pip\_vendor\pygments\formatters\groff.py", "Python", 0, 0, 0, -128, 0, 0, -43, -171
"c:\Users\edwar\OneDrive\Documents\Programming\Visual Studio 2022\PARTS_Web\app\bot_env\Lib\site-packages\pip\_vendor\pygments\formatters\html.py", "Python", 0, 0, 0, -789, 0, -23, -178, -990
"c:\Users\edwar\OneDrive\Documents\Programming\Visual Studio 2022\PARTS_Web\app\bot_env\Lib\site-packages\pip\_vendor\pygments\formatters\img.py", "Python", 0, 0, 0, -520, 0, -22, -104, -646
"c:\Users\edwar\OneDrive\Documents\Programming\Visual Studio 2022\PARTS_Web\app\bot_env\Lib\site-packages\pip\_vendor\pygments\formatters\irc.py", "Python", 0, 0, 0, -126, 0, -4, -25, -155
"c:\Users\edwar\OneDrive\Documents\Programming\Visual Studio 2022\PARTS_Web\app\bot_env\Lib\site-packages\pip\_vendor\pygments\formatters\latex.py", "Python", 0, 0, 0, -405, 0, -45, -72, -522
"c:\Users\edwar\OneDrive\Documents\Programming\Visual Studio 2022\PARTS_Web\app\bot_env\Lib\site-packages\pip\_vendor\pygments\formatters\other.py", "Python", 0, 0, 0, -129, 0, -3, -30, -162
"c:\Users\edwar\OneDrive\Documents\Programming\Visual Studio 2022\PARTS_Web\app\bot_env\Lib\site-packages\pip\_vendor\pygments\formatters\pangomarkup.py", "Python", 0, 0, 0, -62, 0, 0, -22, -84
"c:\Users\edwar\OneDrive\Documents\Programming\Visual Studio 2022\PARTS_Web\app\bot_env\Lib\site-packages\pip\_vendor\pygments\formatters\rtf.py", "Python", 0, 0, 0, -111, 0, -9, -27, -147
"c:\Users\edwar\OneDrive\Documents\Programming\Visual Studio 2022\PARTS_Web\app\bot_env\Lib\site-packages\pip\_vendor\pygments\formatters\svg.py", "Python", 0, 0, 0, -156, 0, 0, -33, -189
"c:\Users\edwar\OneDrive\Documents\Programming\Visual Studio 2022\PARTS_Web\app\bot_env\Lib\site-packages\pip\_vendor\pygments\formatters\terminal.py", "Python", 0, 0, 0, -97, 0, -5, -26, -128
"c:\Users\edwar\OneDrive\Documents\Programming\Visual Studio 2022\PARTS_Web\app\bot_env\Lib\site-packages\pip\_vendor\pygments\formatters\terminal256.py", "Python", 0, 0, 0, -255, 0, -21, -63, -339
"c:\Users\edwar\OneDrive\Documents\Programming\Visual Studio 2022\PARTS_Web\app\bot_env\Lib\site-packages\pip\_vendor\pygments\lexer.py", "Python", 0, 0, 0, -719, 0, -85, -140, -944
"c:\Users\edwar\OneDrive\Documents\Programming\Visual Studio 2022\PARTS_Web\app\bot_env\Lib\site-packages\pip\_vendor\pygments\lexers\__init__.py", "Python", 0, 0, 0, -275, 0, -22, -66, -363
"c:\Users\edwar\OneDrive\Documents\Programming\Visual Studio 2022\PARTS_Web\app\bot_env\Lib\site-packages\pip\_vendor\pygments\lexers\_mapping.py", "Python", 0, 0, 0, -556, 0, -2, -2, -560
"c:\Users\edwar\OneDrive\Documents\Programming\Visual Studio 2022\PARTS_Web\app\bot_env\Lib\site-packages\pip\_vendor\pygments\lexers\python.py", "Python", 0, 0, 0, -1056, 0, -67, -76, -1199
"c:\Users\edwar\OneDrive\Documents\Programming\Visual Studio 2022\PARTS_Web\app\bot_env\Lib\site-packages\pip\_vendor\pygments\modeline.py", "Python", 0, 0, 0, -32, 0, 0, -12, -44
"c:\Users\edwar\OneDrive\Documents\Programming\Visual Studio 2022\PARTS_Web\app\bot_env\Lib\site-packages\pip\_vendor\pygments\plugin.py", "Python", 0, 0, 0, -61, 0, -4, -24, -89
"c:\Users\edwar\OneDrive\Documents\Programming\Visual Studio 2022\PARTS_Web\app\bot_env\Lib\site-packages\pip\_vendor\pygments\regexopt.py", "Python", 0, 0, 0, -66, 0, -13, -13, -92
"c:\Users\edwar\OneDrive\Documents\Programming\Visual Studio 2022\PARTS_Web\app\bot_env\Lib\site-packages\pip\_vendor\pygments\scanner.py", "Python", 0, 0, 0, -89, 0, 0, -16, -105
"c:\Users\edwar\OneDrive\Documents\Programming\Visual Studio 2022\PARTS_Web\app\bot_env\Lib\site-packages\pip\_vendor\pygments\sphinxext.py", "Python", 0, 0, 0, -174, 0, 0, -44, -218
"c:\Users\edwar\OneDrive\Documents\Programming\Visual Studio 2022\PARTS_Web\app\bot_env\Lib\site-packages\pip\_vendor\pygments\style.py", "Python", 0, 0, 0, -153, 0, -17, -28, -198
"c:\Users\edwar\OneDrive\Documents\Programming\Visual Studio 2022\PARTS_Web\app\bot_env\Lib\site-packages\pip\_vendor\pygments\styles\__init__.py", "Python", 0, 0, 0, -90, 0, -3, -11, -104
"c:\Users\edwar\OneDrive\Documents\Programming\Visual Studio 2022\PARTS_Web\app\bot_env\Lib\site-packages\pip\_vendor\pygments\token.py", "Python", 0, 0, 0, -164, 0, -12, -38, -214
"c:\Users\edwar\OneDrive\Documents\Programming\Visual Studio 2022\PARTS_Web\app\bot_env\Lib\site-packages\pip\_vendor\pygments\unistring.py", "Python", 0, 0, 0, -94, 0, -6, -54, -154
"c:\Users\edwar\OneDrive\Documents\Programming\Visual Studio 2022\PARTS_Web\app\bot_env\Lib\site-packages\pip\_vendor\pygments\util.py", "Python", 0, 0, 0, -269, 0, -5, -57, -331
"c:\Users\edwar\OneDrive\Documents\Programming\Visual Studio 2022\PARTS_Web\app\bot_env\Lib\site-packages\pip\_vendor\pyparsing\__init__.py", "Python", 0, 0, 0, -268, 0, -26, -29, -323
"c:\Users\edwar\OneDrive\Documents\Programming\Visual Studio 2022\PARTS_Web\app\bot_env\Lib\site-packages\pip\_vendor\pyparsing\actions.py", "Python", 0, 0, 0, -151, 0, -8, -59, -218
"c:\Users\edwar\OneDrive\Documents\Programming\Visual Studio 2022\PARTS_Web\app\bot_env\Lib\site-packages\pip\_vendor\pyparsing\common.py", "Python", 0, 0, 0, -312, 0, -39, -82, -433
"c:\Users\edwar\OneDrive\Documents\Programming\Visual Studio 2022\PARTS_Web\app\bot_env\Lib\site-packages\pip\_vendor\pyparsing\core.py", "Python", 0, 0, 0, -4805, 0, -271, -1040, -6116
"c:\Users\edwar\OneDrive\Documents\Programming\Visual Studio 2022\PARTS_Web\app\bot_env\Lib\site-packages\pip\_vendor\pyparsing\diagram\__init__.py", "Python", 0, 0, 0, -517, 0, -59, -81, -657
"c:\Users\edwar\OneDrive\Documents\Programming\Visual Studio 2022\PARTS_Web\app\bot_env\Lib\site-packages\pip\_vendor\pyparsing\exceptions.py", "Python", 0, 0, 0, -232, 0, -7, -61, -300
"c:\Users\edwar\OneDrive\Documents\Programming\Visual Studio 2022\PARTS_Web\app\bot_env\Lib\site-packages\pip\_vendor\pyparsing\helpers.py", "Python", 0, 0, 0, -871, 0, -41, -189, -1101
"c:\Users\edwar\OneDrive\Documents\Programming\Visual Studio 2022\PARTS_Web\app\bot_env\Lib\site-packages\pip\_vendor\pyparsing\results.py", "Python", 0, 0, 0, -642, 0, -26, -129, -797
"c:\Users\edwar\OneDrive\Documents\Programming\Visual Studio 2022\PARTS_Web\app\bot_env\Lib\site-packages\pip\_vendor\pyparsing\testing.py", "Python", 0, 0, 0, -279, 0, -10, -43, -332
"c:\Users\edwar\OneDrive\Documents\Programming\Visual Studio 2022\PARTS_Web\app\bot_env\Lib\site-packages\pip\_vendor\pyparsing\unicode.py", "Python", 0, 0, 0, -307, 0, -5, -50, -362
"c:\Users\edwar\OneDrive\Documents\Programming\Visual Studio 2022\PARTS_Web\app\bot_env\Lib\site-packages\pip\_vendor\pyparsing\util.py", "Python", 0, 0, 0, -212, 0, -13, -60, -285
"c:\Users\edwar\OneDrive\Documents\Programming\Visual Studio 2022\PARTS_Web\app\bot_env\Lib\site-packages\pip\_vendor\pyproject_hooks\__init__.py", "Python", 0, 0, 0, -21, 0, 0, -3, -24
"c:\Users\edwar\OneDrive\Documents\Programming\Visual Studio 2022\PARTS_Web\app\bot_env\Lib\site-packages\pip\_vendor\pyproject_hooks\_compat.py", "Python", 0, 0, 0, -6, 0, 0, -3, -9
"c:\Users\edwar\OneDrive\Documents\Programming\Visual Studio 2022\PARTS_Web\app\bot_env\Lib\site-packages\pip\_vendor\pyproject_hooks\_impl.py", "Python", 0, 0, 0, -258, 0, -4, -69, -331
"c:\Users\edwar\OneDrive\Documents\Programming\Visual Studio 2022\PARTS_Web\app\bot_env\Lib\site-packages\pip\_vendor\pyproject_hooks\_in_process\__init__.py", "Python", 0, 0, 0, -14, 0, -1, -4, -19
"c:\Users\edwar\OneDrive\Documents\Programming\Visual Studio 2022\PARTS_Web\app\bot_env\Lib\site-packages\pip\_vendor\pyproject_hooks\_in_process\_in_process.py", "Python", 0, 0, 0, -274, 0, -6, -74, -354
"c:\Users\edwar\OneDrive\Documents\Programming\Visual Studio 2022\PARTS_Web\app\bot_env\Lib\site-packages\pip\_vendor\requests\__init__.py", "Python", 0, 0, 0, -128, 0, -21, -34, -183
"c:\Users\edwar\OneDrive\Documents\Programming\Visual Studio 2022\PARTS_Web\app\bot_env\Lib\site-packages\pip\_vendor\requests\__version__.py", "Python", 0, 0, 0, -10, 0, -3, -2, -15
"c:\Users\edwar\OneDrive\Documents\Programming\Visual Studio 2022\PARTS_Web\app\bot_env\Lib\site-packages\pip\_vendor\requests\_internal_utils.py", "Python", 0, 0, 0, -40, 0, 0, -11, -51
"c:\Users\edwar\OneDrive\Documents\Programming\Visual Studio 2022\PARTS_Web\app\bot_env\Lib\site-packages\pip\_vendor\requests\adapters.py", "Python", 0, 0, 0, -432, 0, -13, -94, -539
"c:\Users\edwar\OneDrive\Documents\Programming\Visual Studio 2022\PARTS_Web\app\bot_env\Lib\site-packages\pip\_vendor\requests\api.py", "Python", 0, 0, 0, -117, 0, -3, -38, -158
"c:\Users\edwar\OneDrive\Documents\Programming\Visual Studio 2022\PARTS_Web\app\bot_env\Lib\site-packages\pip\_vendor\requests\auth.py", "Python", 0, 0, 0, -223, 0, -27, -66, -316
"c:\Users\edwar\OneDrive\Documents\Programming\Visual Studio 2022\PARTS_Web\app\bot_env\Lib\site-packages\pip\_vendor\requests\certs.py", "Python", 0, 0, 0, -17, 0, -1, -7, -25
"c:\Users\edwar\OneDrive\Documents\Programming\Visual Studio 2022\PARTS_Web\app\bot_env\Lib\site-packages\pip\_vendor\requests\compat.py", "Python", 0, 0, 0, -44, 0, -12, -12, -68
"c:\Users\edwar\OneDrive\Documents\Programming\Visual Studio 2022\PARTS_Web\app\bot_env\Lib\site-packages\pip\_vendor\requests\cookies.py", "Python", 0, 0, 0, -439, 0, -12, -111, -562
"c:\Users\edwar\OneDrive\Documents\Programming\Visual Studio 2022\PARTS_Web\app\bot_env\Lib\site-packages\pip\_vendor\requests\exceptions.py", "Python", 0, 0, 0, -82, 0, -1, -59, -142
"c:\Users\edwar\OneDrive\Documents\Programming\Visual Studio 2022\PARTS_Web\app\bot_env\Lib\site-packages\pip\_vendor\requests\help.py", "Python", 0, 0, 0, -109, 0, 0, -23, -132
"c:\Users\edwar\OneDrive\Documents\Programming\Visual Studio 2022\PARTS_Web\app\bot_env\Lib\site-packages\pip\_vendor\requests\hooks.py", "Python", 0, 0, 0, -23, 0, -1, -10, -34
"c:\Users\edwar\OneDrive\Documents\Programming\Visual Studio 2022\PARTS_Web\app\bot_env\Lib\site-packages\pip\_vendor\requests\models.py", "Python", 0, 0, 0, -737, 0, -114, -184, -1035
"c:\Users\edwar\OneDrive\Documents\Programming\Visual Studio 2022\PARTS_Web\app\bot_env\Lib\site-packages\pip\_vendor\requests\packages.py", "Python", 0, 0, 0, -8, 0, -5, -4, -17
"c:\Users\edwar\OneDrive\Documents\Programming\Visual Studio 2022\PARTS_Web\app\bot_env\Lib\site-packages\pip\_vendor\requests\sessions.py", "Python", 0, 0, 0, -564, 0, -116, -154, -834
"c:\Users\edwar\OneDrive\Documents\Programming\Visual Studio 2022\PARTS_Web\app\bot_env\Lib\site-packages\pip\_vendor\requests\status_codes.py", "Python", 0, 0, 0, -112, 0, -4, -13, -129
"c:\Users\edwar\OneDrive\Documents\Programming\Visual Studio 2022\PARTS_Web\app\bot_env\Lib\site-packages\pip\_vendor\requests\structures.py", "Python", 0, 0, 0, -67, 0, -5, -28, -100
"c:\Users\edwar\OneDrive\Documents\Programming\Visual Studio 2022\PARTS_Web\app\bot_env\Lib\site-packages\pip\_vendor\requests\utils.py", "Python", 0, 0, 0, -775, 0, -86, -234, -1095
"c:\Users\edwar\OneDrive\Documents\Programming\Visual Studio 2022\PARTS_Web\app\bot_env\Lib\site-packages\pip\_vendor\resolvelib\__init__.py", "Python", 0, 0, 0, -23, 0, 0, -4, -27
"c:\Users\edwar\OneDrive\Documents\Programming\Visual Studio 2022\PARTS_Web\app\bot_env\Lib\site-packages\pip\_vendor\resolvelib\compat\__init__.py", "Python", 0, 0, 0, 0, 0, 0, -1, -1
"c:\Users\edwar\OneDrive\Documents\Programming\Visual Studio 2022\PARTS_Web\app\bot_env\Lib\site-packages\pip\_vendor\resolvelib\compat\collections_abc.py", "Python", 0, 0, 0, -5, 0, 0, -2, -7
"c:\Users\edwar\OneDrive\Documents\Programming\Visual Studio 2022\PARTS_Web\app\bot_env\Lib\site-packages\pip\_vendor\resolvelib\providers.py", "Python", 0, 0, 0, -105, 0, 0, -29, -134
"c:\Users\edwar\OneDrive\Documents\Programming\Visual Studio 2022\PARTS_Web\app\bot_env\Lib\site-packages\pip\_vendor\resolvelib\reporters.py", "Python", 0, 0, 0, -31, 0, 0, -13, -44
"c:\Users\edwar\OneDrive\Documents\Programming\Visual Studio 2022\PARTS_Web\app\bot_env\Lib\site-packages\pip\_vendor\resolvelib\resolvers.py", "Python", 0, 0, 0, -417, 0, -33, -98, -548
"c:\Users\edwar\OneDrive\Documents\Programming\Visual Studio 2022\PARTS_Web\app\bot_env\Lib\site-packages\pip\_vendor\resolvelib\structs.py", "Python", 0, 0, 0, -127, 0, 0, -44, -171
"c:\Users\edwar\OneDrive\Documents\Programming\Visual Studio 2022\PARTS_Web\app\bot_env\Lib\site-packages\pip\_vendor\rich\__init__.py", "Python", 0, 0, 0, -142, 0, -3, -33, -178
"c:\Users\edwar\OneDrive\Documents\Programming\Visual Studio 2022\PARTS_Web\app\bot_env\Lib\site-packages\pip\_vendor\rich\__main__.py", "Python", 0, 0, 0, -234, 0, -2, -39, -275
"c:\Users\edwar\OneDrive\Documents\Programming\Visual Studio 2022\PARTS_Web\app\bot_env\Lib\site-packages\pip\_vendor\rich\_cell_widths.py", "Python", 0, 0, 0, -449, 0, -1, -2, -452
"c:\Users\edwar\OneDrive\Documents\Programming\Visual Studio 2022\PARTS_Web\app\bot_env\Lib\site-packages\pip\_vendor\rich\_emoji_codes.py", "Python", 0, 0, 0, -3610, 0, 0, -1, -3611
"c:\Users\edwar\OneDrive\Documents\Programming\Visual Studio 2022\PARTS_Web\app\bot_env\Lib\site-packages\pip\_vendor\rich\_emoji_replace.py", "Python", 0, 0, 0, -25, 0, 0, -8, -33
"c:\Users\edwar\OneDrive\Documents\Programming\Visual Studio 2022\PARTS_Web\app\bot_env\Lib\site-packages\pip\_vendor\rich\_export_format.py", "Python", 0, 0, 0, -68, 0, 0, -9, -77
"c:\Users\edwar\OneDrive\Documents\Programming\Visual Studio 2022\PARTS_Web\app\bot_env\Lib\site-packages\pip\_vendor\rich\_extension.py", "Python", 0, 0, 0, -6, 0, -1, -4, -11
"c:\Users\edwar\OneDrive\Documents\Programming\Visual Studio 2022\PARTS_Web\app\bot_env\Lib\site-packages\pip\_vendor\rich\_fileno.py", "Python", 0, 0, 0, -16, 0, -3, -6, -25
"c:\Users\edwar\OneDrive\Documents\Programming\Visual Studio 2022\PARTS_Web\app\bot_env\Lib\site-packages\pip\_vendor\rich\_inspect.py", "Python", 0, 0, 0, -227, 0, -4, -40, -271
"c:\Users\edwar\OneDrive\Documents\Programming\Visual Studio 2022\PARTS_Web\app\bot_env\Lib\site-packages\pip\_vendor\rich\_log_render.py", "Python", 0, 0, 0, -81, 0, 0, -14, -95
"c:\Users\edwar\OneDrive\Documents\Programming\Visual Studio 2022\PARTS_Web\app\bot_env\Lib\site-packages\pip\_vendor\rich\_loop.py", "Python", 0, 0, 0, -36, 0, 0, -8, -44
"c:\Users\edwar\OneDrive\Documents\Programming\Visual Studio 2022\PARTS_Web\app\bot_env\Lib\site-packages\pip\_vendor\rich\_null_file.py", "Python", 0, 0, 0, -47, 0, 0, -23, -70
"c:\Users\edwar\OneDrive\Documents\Programming\Visual Studio 2022\PARTS_Web\app\bot_env\Lib\site-packages\pip\_vendor\rich\_palettes.py", "Python", 0, 0, 0, -301, 0, -3, -6, -310
"c:\Users\edwar\OneDrive\Documents\Programming\Visual Studio 2022\PARTS_Web\app\bot_env\Lib\site-packages\pip\_vendor\rich\_pick.py", "Python", 0, 0, 0, -13, 0, 0, -5, -18
"c:\Users\edwar\OneDrive\Documents\Programming\Visual Studio 2022\PARTS_Web\app\bot_env\Lib\site-packages\pip\_vendor\rich\_ratio.py", "Python", 0, 0, 0, -122, 0, -12, -27, -161
"c:\Users\edwar\OneDrive\Documents\Programming\Visual Studio 2022\PARTS_Web\app\bot_env\Lib\site-packages\pip\_vendor\rich\_spinners.py", "Python", 0, 0, 0, -481, 0, 0, -2, -483
"c:\Users\edwar\OneDrive\Documents\Programming\Visual Studio 2022\PARTS_Web\app\bot_env\Lib\site-packages\pip\_vendor\rich\_stack.py", "Python", 0, 0, 0, -11, 0, 0, -6, -17
"c:\Users\edwar\OneDrive\Documents\Programming\Visual Studio 2022\PARTS_Web\app\bot_env\Lib\site-packages\pip\_vendor\rich\_timer.py", "Python", 0, 0, 0, -14, 0, 0, -6, -20
"c:\Users\edwar\OneDrive\Documents\Programming\Visual Studio 2022\PARTS_Web\app\bot_env\Lib\site-packages\pip\_vendor\rich\_win32_console.py", "Python", 0, 0, 0, -527, 0, -4, -132, -663
"c:\Users\edwar\OneDrive\Documents\Programming\Visual Studio 2022\PARTS_Web\app\bot_env\Lib\site-packages\pip\_vendor\rich\_windows.py", "Python", 0, 0, 0, -55, 0, -1, -17, -73
"c:\Users\edwar\OneDrive\Documents\Programming\Visual Studio 2022\PARTS_Web\app\bot_env\Lib\site-packages\pip\_vendor\rich\_windows_renderer.py", "Python", 0, 0, 0, -52, 0, 0, -5, -57
"c:\Users\edwar\OneDrive\Documents\Programming\Visual Studio 2022\PARTS_Web\app\bot_env\Lib\site-packages\pip\_vendor\rich\_wrap.py", "Python", 0, 0, 0, -46, 0, 0, -11, -57
"c:\Users\edwar\OneDrive\Documents\Programming\Visual Studio 2022\PARTS_Web\app\bot_env\Lib\site-packages\pip\_vendor\rich\abc.py", "Python", 0, 0, 0, -22, 0, 0, -12, -34
"c:\Users\edwar\OneDrive\Documents\Programming\Visual Studio 2022\PARTS_Web\app\bot_env\Lib\site-packages\pip\_vendor\rich\align.py", "Python", 0, 0, 0, -270, 0, -4, -38, -312
"c:\Users\edwar\OneDrive\Documents\Programming\Visual Studio 2022\PARTS_Web\app\bot_env\Lib\site-packages\pip\_vendor\rich\ansi.py", "Python", 0, 0, 0, -201, 0, -6, -34, -241
"c:\Users\edwar\OneDrive\Documents\Programming\Visual Studio 2022\PARTS_Web\app\bot_env\Lib\site-packages\pip\_vendor\rich\bar.py", "Python", 0, 0, 0, -71, 0, -5, -19, -95
"c:\Users\edwar\OneDrive\Documents\Programming\Visual Studio 2022\PARTS_Web\app\bot_env\Lib\site-packages\pip\_vendor\rich\box.py", "Python", 0, 0, 0, -418, 0, -11, -89, -518
"c:\Users\edwar\OneDrive\Documents\Programming\Visual Studio 2022\PARTS_Web\app\bot_env\Lib\site-packages\pip\_vendor\rich\cells.py", "Python", 0, 0, 0, -117, 0, -4, -34, -155
"c:\Users\edwar\OneDrive\Documents\Programming\Visual Studio 2022\PARTS_Web\app\bot_env\Lib\site-packages\pip\_vendor\rich\color.py", "Python", 0, 0, 0, -544, 0, -3, -76, -623
"c:\Users\edwar\OneDrive\Documents\Programming\Visual Studio 2022\PARTS_Web\app\bot_env\Lib\site-packages\pip\_vendor\rich\color_triplet.py", "Python", 0, 0, 0, -30, 0, 0, -9, -39
"c:\Users\edwar\OneDrive\Documents\Programming\Visual Studio 2022\PARTS_Web\app\bot_env\Lib\site-packages\pip\_vendor\rich\columns.py", "Python", 0, 0, 0, -166, 0, -1, -21, -188
"c:\Users\edwar\OneDrive\Documents\Programming\Visual Studio 2022\PARTS_Web\app\bot_env\Lib\site-packages\pip\_vendor\rich\console.py", "Python", 0, 0, 0, -2244, 0, -19, -371, -2634
"c:\Users\edwar\OneDrive\Documents\Programming\Visual Studio 2022\PARTS_Web\app\bot_env\Lib\site-packages\pip\_vendor\rich\constrain.py", "Python", 0, 0, 0, -29, 0, 0, -9, -38
"c:\Users\edwar\OneDrive\Documents\Programming\Visual Studio 2022\PARTS_Web\app\bot_env\Lib\site-packages\pip\_vendor\rich\containers.py", "Python", 0, 0, 0, -139, 0, 0, -29, -168
"c:\Users\edwar\OneDrive\Documents\Programming\Visual Studio 2022\PARTS_Web\app\bot_env\Lib\site-packages\pip\_vendor\rich\control.py", "Python", 0, 0, 0, -180, 0, -1, -45, -226
"c:\Users\edwar\OneDrive\Documents\Programming\Visual Studio 2022\PARTS_Web\app\bot_env\Lib\site-packages\pip\_vendor\rich\default_styles.py", "Python", 0, 0, 0, -181, 0, 0, -10, -191
"c:\Users\edwar\OneDrive\Documents\Programming\Visual Studio 2022\PARTS_Web\app\bot_env\Lib\site-packages\pip\_vendor\rich\diagnose.py", "Python", 0, 0, 0, -30, 0, 0, -8, -38
"c:\Users\edwar\OneDrive\Documents\Programming\Visual Studio 2022\PARTS_Web\app\bot_env\Lib\site-packages\pip\_vendor\rich\emoji.py", "Python", 0, 0, 0, -70, 0, 0, -27, -97
"c:\Users\edwar\OneDrive\Documents\Programming\Visual Studio 2022\PARTS_Web\app\bot_env\Lib\site-packages\pip\_vendor\rich\errors.py", "Python", 0, 0, 0, -18, 0, 0, -17, -35
"c:\Users\edwar\OneDrive\Documents\Programming\Visual Studio 2022\PARTS_Web\app\bot_env\Lib\site-packages\pip\_vendor\rich\file_proxy.py", "Python", 0, 0, 0, -47, 0, 0, -11, -58
"c:\Users\edwar\OneDrive\Documents\Programming\Visual Studio 2022\PARTS_Web\app\bot_env\Lib\site-packages\pip\_vendor\rich\filesize.py", "Python", 0, 0, 0, -70, 0, -1, -19, -90
"c:\Users\edwar\OneDrive\Documents\Programming\Visual Studio 2022\PARTS_Web\app\bot_env\Lib\site-packages\pip\_vendor\rich\highlighter.py", "Python", 0, 0, 0, -151, 0, -37, -45, -233
"c:\Users\edwar\OneDrive\Documents\Programming\Visual Studio 2022\PARTS_Web\app\bot_env\Lib\site-packages\pip\_vendor\rich\json.py", "Python", 0, 0, 0, -123, 0, 0, -18, -141
"c:\Users\edwar\OneDrive\Documents\Programming\Visual Studio 2022\PARTS_Web\app\bot_env\Lib\site-packages\pip\_vendor\rich\jupyter.py", "Python", 0, 0, 0, -77, 0, -2, -23, -102
"c:\Users\edwar\OneDrive\Documents\Programming\Visual Studio 2022\PARTS_Web\app\bot_env\Lib\site-packages\pip\_vendor\rich\layout.py", "Python", 0, 0, 0, -358, 0, 0, -86, -444
"c:\Users\edwar\OneDrive\Documents\Programming\Visual Studio 2022\PARTS_Web\app\bot_env\Lib\site-packages\pip\_vendor\rich\live.py", "Python", 0, 0, 0, -321, 0, -6, -49, -376
"c:\Users\edwar\OneDrive\Documents\Programming\Visual Studio 2022\PARTS_Web\app\bot_env\Lib\site-packages\pip\_vendor\rich\live_render.py", "Python", 0, 0, 0, -95, 0, 0, -19, -114
"c:\Users\edwar\OneDrive\Documents\Programming\Visual Studio 2022\PARTS_Web\app\bot_env\Lib\site-packages\pip\_vendor\rich\logging.py", "Python", 0, 0, 0, -253, 0, -4, -33, -290
"c:\Users\edwar\OneDrive\Documents\Programming\Visual Studio 2022\PARTS_Web\app\bot_env\Lib\site-packages\pip\_vendor\rich\markup.py", "Python", 0, 0, 0, -197, 0, -3, -47, -247
"c:\Users\edwar\OneDrive\Documents\Programming\Visual Studio 2022\PARTS_Web\app\bot_env\Lib\site-packages\pip\_vendor\rich\measure.py", "Python", 0, 0, 0, -126, 0, 0, -26, -152
"c:\Users\edwar\OneDrive\Documents\Programming\Visual Studio 2022\PARTS_Web\app\bot_env\Lib\site-packages\pip\_vendor\rich\padding.py", "Python", 0, 0, 0, -121, 0, 0, -21, -142
"c:\Users\edwar\OneDrive\Documents\Programming\Visual Studio 2022\PARTS_Web\app\bot_env\Lib\site-packages\pip\_vendor\rich\pager.py", "Python", 0, 0, 0, -23, 0, 0, -12, -35
"c:\Users\edwar\OneDrive\Documents\Programming\Visual Studio 2022\PARTS_Web\app\bot_env\Lib\site-packages\pip\_vendor\rich\palette.py", "Python", 0, 0, 0, -82, 0, -1, -18, -101
"c:\Users\edwar\OneDrive\Documents\Programming\Visual Studio 2022\PARTS_Web\app\bot_env\Lib\site-packages\pip\_vendor\rich\panel.py", "Python", 0, 0, 0, -277, 0, 0, -32, -309
"c:\Users\edwar\OneDrive\Documents\Programming\Visual Studio 2022\PARTS_Web\app\bot_env\Lib\site-packages\pip\_vendor\rich\pretty.py", "Python", 0, 0, 0, -862, 0, -15, -118, -995
"c:\Users\edwar\OneDrive\Documents\Programming\Visual Studio 2022\PARTS_Web\app\bot_env\Lib\site-packages\pip\_vendor\rich\progress.py", "Python", 0, 0, 0, -1434, 0, -10, -259, -1703
"c:\Users\edwar\OneDrive\Documents\Programming\Visual Studio 2022\PARTS_Web\app\bot_env\Lib\site-packages\pip\_vendor\rich\progress_bar.py", "Python", 0, 0, 0, -193, 0, -1, -31, -225
"c:\Users\edwar\OneDrive\Documents\Programming\Visual Studio 2022\PARTS_Web\app\bot_env\Lib\site-packages\pip\_vendor\rich\prompt.py", "Python", 0, 0, 0, -295, 0, 0, -82, -377
"c:\Users\edwar\OneDrive\Documents\Programming\Visual Studio 2022\PARTS_Web\app\bot_env\Lib\site-packages\pip\_vendor\rich\protocol.py", "Python", 0, 0, 0, -31, 0, -1, -11, -43
"c:\Users\edwar\OneDrive\Documents\Programming\Visual Studio 2022\PARTS_Web\app\bot_env\Lib\site-packages\pip\_vendor\rich\region.py", "Python", 0, 0, 0, -7, 0, 0, -4, -11
"c:\Users\edwar\OneDrive\Documents\Programming\Visual Studio 2022\PARTS_Web\app\bot_env\Lib\site-packages\pip\_vendor\rich\repr.py", "Python", 0, 0, 0, -116, 0, 0, -34, -150
"c:\Users\edwar\OneDrive\Documents\Programming\Visual Studio 2022\PARTS_Web\app\bot_env\Lib\site-packages\pip\_vendor\rich\rule.py", "Python", 0, 0, 0, -109, 0, 0, -22, -131
"c:\Users\edwar\OneDrive\Documents\Programming\Visual Studio 2022\PARTS_Web\app\bot_env\Lib\site-packages\pip\_vendor\rich\scope.py", "Python", 0, 0, 0, -73, 0, 0, -14, -87
"c:\Users\edwar\OneDrive\Documents\Programming\Visual Studio 2022\PARTS_Web\app\bot_env\Lib\site-packages\pip\_vendor\rich\screen.py", "Python", 0, 0, 0, -44, 0, 0, -11, -55
"c:\Users\edwar\OneDrive\Documents\Programming\Visual Studio 2022\PARTS_Web\app\bot_env\Lib\site-packages\pip\_vendor\rich\segment.py", "Python", 0, 0, 0, -624, 0, -1, -115, -740
"c:\Users\edwar\OneDrive\Documents\Programming\Visual Studio 2022\PARTS_Web\app\bot_env\Lib\site-packages\pip\_vendor\rich\spinner.py", "Python", 0, 0, 0, -115, 0, 0, -23, -138
"c:\Users\edwar\OneDrive\Documents\Programming\Visual Studio 2022\PARTS_Web\app\bot_env\Lib\site-packages\pip\_vendor\rich\status.py", "Python", 0, 0, 0, -113, 0, 0, -20, -133
"c:\Users\edwar\OneDrive\Documents\Programming\Visual Studio 2022\PARTS_Web\app\bot_env\Lib\site-packages\pip\_vendor\rich\style.py", "Python", 0, 0, 0, -696, 0, -2, -99, -797
"c:\Users\edwar\OneDrive\Documents\Programming\Visual Studio 2022\PARTS_Web\app\bot_env\Lib\site-packages\pip\_vendor\rich\styled.py", "Python", 0, 0, 0, -31, 0, 0, -12, -43
"c:\Users\edwar\OneDrive\Documents\Programming\Visual Studio 2022\PARTS_Web\app\bot_env\Lib\site-packages\pip\_vendor\rich\syntax.py", "Python", 0, 0, 0, -831, 0, -13, -105, -949
"c:\Users\edwar\OneDrive\Documents\Programming\Visual Studio 2022\PARTS_Web\app\bot_env\Lib\site-packages\pip\_vendor\rich\table.py", "Python", 0, 0, 0, -878, 0, -4, -121, -1003
"c:\Users\edwar\OneDrive\Documents\Programming\Visual Studio 2022\PARTS_Web\app\bot_env\Lib\site-packages\pip\_vendor\rich\terminal_theme.py", "Python", 0, 0, 0, -143, 0, 0, -11, -154
"c:\Users\edwar\OneDrive\Documents\Programming\Visual Studio 2022\PARTS_Web\app\bot_env\Lib\site-packages\pip\_vendor\rich\text.py", "Python", 0, 0, 0, -1117, 0, -5, -186, -1308
"c:\Users\edwar\OneDrive\Documents\Programming\Visual Studio 2022\PARTS_Web\app\bot_env\Lib\site-packages\pip\_vendor\rich\theme.py", "Python", 0, 0, 0, -91, 0, 0, -25, -116
"c:\Users\edwar\OneDrive\Documents\Programming\Visual Studio 2022\PARTS_Web\app\bot_env\Lib\site-packages\pip\_vendor\rich\themes.py", "Python", 0, 0, 0, -3, 0, 0, -3, -6
"c:\Users\edwar\OneDrive\Documents\Programming\Visual Studio 2022\PARTS_Web\app\bot_env\Lib\site-packages\pip\_vendor\rich\traceback.py", "Python", 0, 0, 0, -656, 0, -16, -85, -757
"c:\Users\edwar\OneDrive\Documents\Programming\Visual Studio 2022\PARTS_Web\app\bot_env\Lib\site-packages\pip\_vendor\rich\tree.py", "Python", 0, 0, 0, -215, 0, -1, -36, -252
"c:\Users\edwar\OneDrive\Documents\Programming\Visual Studio 2022\PARTS_Web\app\bot_env\Lib\site-packages\pip\_vendor\six.py", "Python", 0, 0, 0, -755, 0, -53, -191, -999
"c:\Users\edwar\OneDrive\Documents\Programming\Visual Studio 2022\PARTS_Web\app\bot_env\Lib\site-packages\pip\_vendor\tenacity\__init__.py", "Python", 0, 0, 0, -461, 0, -41, -107, -609
"c:\Users\edwar\OneDrive\Documents\Programming\Visual Studio 2022\PARTS_Web\app\bot_env\Lib\site-packages\pip\_vendor\tenacity\_asyncio.py", "Python", 0, 0, 0, -61, 0, -18, -16, -95
"c:\Users\edwar\OneDrive\Documents\Programming\Visual Studio 2022\PARTS_Web\app\bot_env\Lib\site-packages\pip\_vendor\tenacity\_utils.py", "Python", 0, 0, 0, -43, 0, -19, -15, -77
"c:\Users\edwar\OneDrive\Documents\Programming\Visual Studio 2022\PARTS_Web\app\bot_env\Lib\site-packages\pip\_vendor\tenacity\after.py", "Python", 0, 0, 0, -25, 0, -16, -11, -52
"c:\Users\edwar\OneDrive\Documents\Programming\Visual Studio 2022\PARTS_Web\app\bot_env\Lib\site-packages\pip\_vendor\tenacity\before.py", "Python", 0, 0, 0, -20, 0, -16, -11, -47
"c:\Users\edwar\OneDrive\Documents\Programming\Visual Studio 2022\PARTS_Web\app\bot_env\Lib\site-packages\pip\_vendor\tenacity\before_sleep.py", "Python", 0, 0, 0, -39, 0, -16, -17, -72
"c:\Users\edwar\OneDrive\Documents\Programming\Visual Studio 2022\PARTS_Web\app\bot_env\Lib\site-packages\pip\_vendor\tenacity\nap.py", "Python", 0, 0, 0, -16, 0, -18, -10, -44
"c:\Users\edwar\OneDrive\Documents\Programming\Visual Studio 2022\PARTS_Web\app\bot_env\Lib\site-packages\pip\_vendor\tenacity\retry.py", "Python", 0, 0, 0, -178, 0, -18, -77, -273
"c:\Users\edwar\OneDrive\Documents\Programming\Visual Studio 2022\PARTS_Web\app\bot_env\Lib\site-packages\pip\_vendor\tenacity\stop.py", "Python", 0, 0, 0, -53, 0, -15, -36, -104
"c:\Users\edwar\OneDrive\Documents\Programming\Visual Studio 2022\PARTS_Web\app\bot_env\Lib\site-packages\pip\_vendor\tenacity\tornadoweb.py", "Python", 0, 0, 0, -37, 0, -13, -10, -60
"c:\Users\edwar\OneDrive\Documents\Programming\Visual Studio 2022\PARTS_Web\app\bot_env\Lib\site-packages\pip\_vendor\tenacity\wait.py", "Python", 0, 0, 0, -152, 0, -16, -61, -229
"c:\Users\edwar\OneDrive\Documents\Programming\Visual Studio 2022\PARTS_Web\app\bot_env\Lib\site-packages\pip\_vendor\tomli\__init__.py", "Python", 0, 0, 0, -4, 0, -4, -4, -12
"c:\Users\edwar\OneDrive\Documents\Programming\Visual Studio 2022\PARTS_Web\app\bot_env\Lib\site-packages\pip\_vendor\tomli\_parser.py", "Python", 0, 0, 0, -534, 0, -46, -112, -692
"c:\Users\edwar\OneDrive\Documents\Programming\Visual Studio 2022\PARTS_Web\app\bot_env\Lib\site-packages\pip\_vendor\tomli\_re.py", "Python", 0, 0, 0, -87, 0, -6, -15, -108
"c:\Users\edwar\OneDrive\Documents\Programming\Visual Studio 2022\PARTS_Web\app\bot_env\Lib\site-packages\pip\_vendor\tomli\_types.py", "Python", 0, 0, 0, -4, 0, -4, -3, -11
"c:\Users\edwar\OneDrive\Documents\Programming\Visual Studio 2022\PARTS_Web\app\bot_env\Lib\site-packages\pip\_vendor\truststore\__init__.py", "Python", 0, 0, 0, -8, 0, 0, -6, -14
"c:\Users\edwar\OneDrive\Documents\Programming\Visual Studio 2022\PARTS_Web\app\bot_env\Lib\site-packages\pip\_vendor\truststore\_api.py", "Python", 0, 0, 0, -231, 0, -15, -57, -303
"c:\Users\edwar\OneDrive\Documents\Programming\Visual Studio 2022\PARTS_Web\app\bot_env\Lib\site-packages\pip\_vendor\truststore\_macos.py", "Python", 0, 0, 0, -386, 0, -33, -83, -502
"c:\Users\edwar\OneDrive\Documents\Programming\Visual Studio 2022\PARTS_Web\app\bot_env\Lib\site-packages\pip\_vendor\truststore\_openssl.py", "Python", 0, 0, 0, -37, 0, -20, -10, -67
"c:\Users\edwar\OneDrive\Documents\Programming\Visual Studio 2022\PARTS_Web\app\bot_env\Lib\site-packages\pip\_vendor\truststore\_ssl_constants.py", "Python", 0, 0, 0, -17, 0, -7, -8, -32
"c:\Users\edwar\OneDrive\Documents\Programming\Visual Studio 2022\PARTS_Web\app\bot_env\Lib\site-packages\pip\_vendor\truststore\_windows.py", "Python", 0, 0, 0, -451, 0, -22, -82, -555
"c:\Users\edwar\OneDrive\Documents\Programming\Visual Studio 2022\PARTS_Web\app\bot_env\Lib\site-packages\pip\_vendor\typing_extensions.py", "Python", 0, 0, 0, -2304, 0, -194, -575, -3073
"c:\Users\edwar\OneDrive\Documents\Programming\Visual Studio 2022\PARTS_Web\app\bot_env\Lib\site-packages\pip\_vendor\urllib3\__init__.py", "Python", 0, 0, 0, -72, 0, -15, -16, -103
"c:\Users\edwar\OneDrive\Documents\Programming\Visual Studio 2022\PARTS_Web\app\bot_env\Lib\site-packages\pip\_vendor\urllib3\_collections.py", "Python", 0, 0, 0, -252, 0, -19, -67, -338
"c:\Users\edwar\OneDrive\Documents\Programming\Visual Studio 2022\PARTS_Web\app\bot_env\Lib\site-packages\pip\_vendor\urllib3\_version.py", "Python", 0, 0, 0, -1, 0, -1, -1, -3
"c:\Users\edwar\OneDrive\Documents\Programming\Visual Studio 2022\PARTS_Web\app\bot_env\Lib\site-packages\pip\_vendor\urllib3\connection.py", "Python", 0, 0, 0, -422, 0, -54, -97, -573
"c:\Users\edwar\OneDrive\Documents\Programming\Visual Studio 2022\PARTS_Web\app\bot_env\Lib\site-packages\pip\_vendor\urllib3\connectionpool.py", "Python", 0, 0, 0, -835, 0, -115, -183, -1133
"c:\Users\edwar\OneDrive\Documents\Programming\Visual Studio 2022\PARTS_Web\app\bot_env\Lib\site-packages\pip\_vendor\urllib3\contrib\__init__.py", "Python", 0, 0, 0, 0, 0, 0, -1, -1
"c:\Users\edwar\OneDrive\Documents\Programming\Visual Studio 2022\PARTS_Web\app\bot_env\Lib\site-packages\pip\_vendor\urllib3\contrib\_appengine_environ.py", "Python", 0, 0, 0, -24, 0, 0, -13, -37
"c:\Users\edwar\OneDrive\Documents\Programming\Visual Studio 2022\PARTS_Web\app\bot_env\Lib\site-packages\pip\_vendor\urllib3\contrib\_securetransport\__init__.py", "Python", 0, 0, 0, 0, 0, 0, -1, -1
"c:\Users\edwar\OneDrive\Documents\Programming\Visual Studio 2022\PARTS_Web\app\bot_env\Lib\site-packages\pip\_vendor\urllib3\contrib\_securetransport\bindings.py", "Python", 0, 0, 0, -414, 0, -9, -97, -520
"c:\Users\edwar\OneDrive\Documents\Programming\Visual Studio 2022\PARTS_Web\app\bot_env\Lib\site-packages\pip\_vendor\urllib3\contrib\_securetransport\low_level.py", "Python", 0, 0, 0, -285, 0, -51, -62, -398
"c:\Users\edwar\OneDrive\Documents\Programming\Visual Studio 2022\PARTS_Web\app\bot_env\Lib\site-packages\pip\_vendor\urllib3\contrib\appengine.py", "Python", 0, 0, 0, -244, 0, -14, -57, -315
"c:\Users\edwar\OneDrive\Documents\Programming\Visual Studio 2022\PARTS_Web\app\bot_env\Lib\site-packages\pip\_vendor\urllib3\contrib\ntlmpool.py", "Python", 0, 0, 0, -104, 0, -7, -20, -131
"c:\Users\edwar\OneDrive\Documents\Programming\Visual Studio 2022\PARTS_Web\app\bot_env\Lib\site-packages\pip\_vendor\urllib3\contrib\pyopenssl.py", "Python", 0, 0, 0, -389, 0, -25, -105, -519
"c:\Users\edwar\OneDrive\Documents\Programming\Visual Studio 2022\PARTS_Web\app\bot_env\Lib\site-packages\pip\_vendor\urllib3\contrib\securetransport.py", "Python", 0, 0, 0, -646, 0, -134, -142, -922
"c:\Users\edwar\OneDrive\Documents\Programming\Visual Studio 2022\PARTS_Web\app\bot_env\Lib\site-packages\pip\_vendor\urllib3\contrib\socks.py", "Python", 0, 0, 0, -167, 0, -7, -43, -217
"c:\Users\edwar\OneDrive\Documents\Programming\Visual Studio 2022\PARTS_Web\app\bot_env\Lib\site-packages\pip\_vendor\urllib3\exceptions.py", "Python", 0, 0, 0, -183, 0, -10, -131, -324
"c:\Users\edwar\OneDrive\Documents\Programming\Visual Studio 2022\PARTS_Web\app\bot_env\Lib\site-packages\pip\_vendor\urllib3\fields.py", "Python", 0, 0, 0, -212, 0, -5, -58, -275
"c:\Users\edwar\OneDrive\Documents\Programming\Visual Studio 2022\PARTS_Web\app\bot_env\Lib\site-packages\pip\_vendor\urllib3\filepost.py", "Python", 0, 0, 0, -70, 0, 0, -29, -99
"c:\Users\edwar\OneDrive\Documents\Programming\Visual Studio 2022\PARTS_Web\app\bot_env\Lib\site-packages\pip\_vendor\urllib3\packages\__init__.py", "Python", 0, 0, 0, 0, 0, 0, -1, -1
"c:\Users\edwar\OneDrive\Documents\Programming\Visual Studio 2022\PARTS_Web\app\bot_env\Lib\site-packages\pip\_vendor\urllib3\packages\backports\__init__.py", "Python", 0, 0, 0, 0, 0, 0, -1, -1
"c:\Users\edwar\OneDrive\Documents\Programming\Visual Studio 2022\PARTS_Web\app\bot_env\Lib\site-packages\pip\_vendor\urllib3\packages\backports\makefile.py", "Python", 0, 0, 0, -47, 0, -1, -4, -52
"c:\Users\edwar\OneDrive\Documents\Programming\Visual Studio 2022\PARTS_Web\app\bot_env\Lib\site-packages\pip\_vendor\urllib3\packages\backports\weakref_finalize.py", "Python", 0, 0, 0, -120, 0, -15, -21, -156
"c:\Users\edwar\OneDrive\Documents\Programming\Visual Studio 2022\PARTS_Web\app\bot_env\Lib\site-packages\pip\_vendor\urllib3\packages\six.py", "Python", 0, 0, 0, -805, 0, -53, -219, -1077
"c:\Users\edwar\OneDrive\Documents\Programming\Visual Studio 2022\PARTS_Web\app\bot_env\Lib\site-packages\pip\_vendor\urllib3\poolmanager.py", "Python", 0, 0, 0, -402, 0, -33, -103, -538
"c:\Users\edwar\OneDrive\Documents\Programming\Visual Studio 2022\PARTS_Web\app\bot_env\Lib\site-packages\pip\_vendor\urllib3\request.py", "Python", 0, 0, 0, -151, 0, 0, -41, -192
"c:\Users\edwar\OneDrive\Documents\Programming\Visual Studio 2022\PARTS_Web\app\bot_env\Lib\site-packages\pip\_vendor\urllib3\response.py", "Python", 0, 0, 0, -669, 0, -79, -132, -880
"c:\Users\edwar\OneDrive\Documents\Programming\Visual Studio 2022\PARTS_Web\app\bot_env\Lib\site-packages\pip\_vendor\urllib3\util\__init__.py", "Python", 0, 0, 0, -46, 0, -1, -3, -50
"c:\Users\edwar\OneDrive\Documents\Programming\Visual Studio 2022\PARTS_Web\app\bot_env\Lib\site-packages\pip\_vendor\urllib3\util\connection.py", "Python", 0, 0, 0, -100, 0, -18, -32, -150
"c:\Users\edwar\OneDrive\Documents\Programming\Visual Studio 2022\PARTS_Web\app\bot_env\Lib\site-packages\pip\_vendor\urllib3\util\proxy.py", "Python", 0, 0, 0, -43, 0, -4, -11, -58
"c:\Users\edwar\OneDrive\Documents\Programming\Visual Studio 2022\PARTS_Web\app\bot_env\Lib\site-packages\pip\_vendor\urllib3\util\queue.py", "Python", 0, 0, 0, -14, 0, -1, -8, -23
"c:\Users\edwar\OneDrive\Documents\Programming\Visual Studio 2022\PARTS_Web\app\bot_env\Lib\site-packages\pip\_vendor\urllib3\util\request.py", "Python", 0, 0, 0, -103, 0, -6, -29, -138
"c:\Users\edwar\OneDrive\Documents\Programming\Visual Studio 2022\PARTS_Web\app\bot_env\Lib\site-packages\pip\_vendor\urllib3\util\response.py", "Python", 0, 0, 0, -64, 0, -20, -24, -108
"c:\Users\edwar\OneDrive\Documents\Programming\Visual Studio 2022\PARTS_Web\app\bot_env\Lib\site-packages\pip\_vendor\urllib3\util\retry.py", "Python", 0, 0, 0, -469, 0, -29, -123, -621
"c:\Users\edwar\OneDrive\Documents\Programming\Visual Studio 2022\PARTS_Web\app\bot_env\Lib\site-packages\pip\_vendor\urllib3\util\ssl_.py", "Python", 0, 0, 0, -352, 0, -59, -85, -496
"c:\Users\edwar\OneDrive\Documents\Programming\Visual Studio 2022\PARTS_Web\app\bot_env\Lib\site-packages\pip\_vendor\urllib3\util\ssl_match_hostname.py", "Python", 0, 0, 0, -99, 0, -37, -24, -160
"c:\Users\edwar\OneDrive\Documents\Programming\Visual Studio 2022\PARTS_Web\app\bot_env\Lib\site-packages\pip\_vendor\urllib3\util\ssltransport.py", "Python", 0, 0, 0, -178, 0, -2, -42, -222
"c:\Users\edwar\OneDrive\Documents\Programming\Visual Studio 2022\PARTS_Web\app\bot_env\Lib\site-packages\pip\_vendor\urllib3\util\timeout.py", "Python", 0, 0, 0, -200, 0, -11, -61, -272
"c:\Users\edwar\OneDrive\Documents\Programming\Visual Studio 2022\PARTS_Web\app\bot_env\Lib\site-packages\pip\_vendor\urllib3\util\url.py", "Python", 0, 0, 0, -320, 0, -37, -79, -436
"c:\Users\edwar\OneDrive\Documents\Programming\Visual Studio 2022\PARTS_Web\app\bot_env\Lib\site-packages\pip\_vendor\urllib3\util\wait.py", "Python", 0, 0, 0, -89, 0, -38, -26, -153
"c:\Users\edwar\OneDrive\Documents\Programming\Visual Studio 2022\PARTS_Web\app\bot_env\Lib\site-packages\pip\_vendor\webencodings\__init__.py", "Python", 0, 0, 0, -249, 0, -14, -80, -343
"c:\Users\edwar\OneDrive\Documents\Programming\Visual Studio 2022\PARTS_Web\app\bot_env\Lib\site-packages\pip\_vendor\webencodings\labels.py", "Python", 0, 0, 0, -223, 0, -2, -7, -232
"c:\Users\edwar\OneDrive\Documents\Programming\Visual Studio 2022\PARTS_Web\app\bot_env\Lib\site-packages\pip\_vendor\webencodings\mklabels.py", "Python", 0, 0, 0, -40, 0, -2, -18, -60
"c:\Users\edwar\OneDrive\Documents\Programming\Visual Studio 2022\PARTS_Web\app\bot_env\Lib\site-packages\pip\_vendor\webencodings\tests.py", "Python", 0, 0, 0, -123, 0, -2, -29, -154
"c:\Users\edwar\OneDrive\Documents\Programming\Visual Studio 2022\PARTS_Web\app\bot_env\Lib\site-packages\pip\_vendor\webencodings\x_user_defined.py", "Python", 0, 0, 0, -292, 0, -7, -27, -326
"c:\Users\edwar\OneDrive\Documents\Programming\Visual Studio 2022\PARTS_Web\app\bot_env\Scripts\Activate.ps1", "PowerShell", 0, 0, -108, 0, 0, -360, -35, -503
"c:\Users\edwar\OneDrive\Documents\Programming\Visual Studio 2022\PARTS_Web\app\bot_env\Scripts\activate.bat", "Batch", 0, -24, 0, 0, 0, -1, -10, -35
"c:\Users\edwar\OneDrive\Documents\Programming\Visual Studio 2022\PARTS_Web\app\bot_env\Scripts\deactivate.bat", "Batch", 0, -16, 0, 0, 0, 0, -7, -23
"c:\Users\edwar\OneDrive\Documents\Programming\Visual Studio 2022\PARTS_Web\app\bot_env\pyvenv.cfg", "Properties", -5, 0, 0, 0, 0, 0, -1, -6
"c:\Users\edwar\OneDrive\Documents\Programming\Visual Studio 2022\PARTS_Web\app\bot_web\Lib\site-packages\pip\__init__.py", "Python", 0, 0, 0, -8, 0, 0, -6, -14
"c:\Users\edwar\OneDrive\Documents\Programming\Visual Studio 2022\PARTS_Web\app\bot_web\Lib\site-packages\pip\__main__.py", "Python", 0, 0, 0, -10, 0, -10, -5, -25
"c:\Users\edwar\OneDrive\Documents\Programming\Visual Studio 2022\PARTS_Web\app\bot_web\Lib\site-packages\pip\__pip-runner__.py", "Python", 0, 0, 0, -29, 0, -4, -18, -51
"c:\Users\edwar\OneDrive\Documents\Programming\Visual Studio 2022\PARTS_Web\app\bot_web\Lib\site-packages\pip\_internal\__init__.py", "Python", 0, 0, 0, -10, 0, -2, -7, -19
"c:\Users\edwar\OneDrive\Documents\Programming\Visual Studio 2022\PARTS_Web\app\bot_web\Lib\site-packages\pip\_internal\build_env.py", "Python", 0, 0, 0, -252, 0, -15, -45, -312
"c:\Users\edwar\OneDrive\Documents\Programming\Visual Studio 2022\PARTS_Web\app\bot_web\Lib\site-packages\pip\_internal\cache.py", "Python", 0, 0, 0, -221, 0, -19, -51, -291
"c:\Users\edwar\OneDrive\Documents\Programming\Visual Studio 2022\PARTS_Web\app\bot_web\Lib\site-packages\pip\_internal\cli\__init__.py", "Python", 0, 0, 0, -2, 0, -1, -2, -5
"c:\Users\edwar\OneDrive\Documents\Programming\Visual Studio 2022\PARTS_Web\app\bot_web\Lib\site-packages\pip\_internal\cli\autocompletion.py", "Python", 0, 0, 0, -135, 0, -19, -19, -173
"c:\Users\edwar\OneDrive\Documents\Programming\Visual Studio 2022\PARTS_Web\app\bot_web\Lib\site-packages\pip\_internal\cli\base_command.py", "Python", 0, 0, 0, -175, 0, -22, -40, -237
"c:\Users\edwar\OneDrive\Documents\Programming\Visual Studio 2022\PARTS_Web\app\bot_web\Lib\site-packages\pip\_internal\cli\cmdoptions.py", "Python", 0, 0, 0, -883, 0, -38, -154, -1075
"c:\Users\edwar\OneDrive\Documents\Programming\Visual Studio 2022\PARTS_Web\app\bot_web\Lib\site-packages\pip\_internal\cli\command_context.py", "Python", 0, 0, 0, -20, 0, 0, -8, -28
"c:\Users\edwar\OneDrive\Documents\Programming\Visual Studio 2022\PARTS_Web\app\bot_web\Lib\site-packages\pip\_internal\cli\main.py", "Python", 0, 0, 0, -34, 0, -30, -16, -80
"c:\Users\edwar\OneDrive\Documents\Programming\Visual Studio 2022\PARTS_Web\app\bot_web\Lib\site-packages\pip\_internal\cli\main_parser.py", "Python", 0, 0, 0, -82, 0, -24, -29, -135
"c:\Users\edwar\OneDrive\Documents\Programming\Visual Studio 2022\PARTS_Web\app\bot_web\Lib\site-packages\pip\_internal\cli\parser.py", "Python", 0, 0, 0, -222, 0, -20, -53, -295
"c:\Users\edwar\OneDrive\Documents\Programming\Visual Studio 2022\PARTS_Web\app\bot_web\Lib\site-packages\pip\_internal\cli\progress_bars.py", "Python", 0, 0, 0, -58, 0, 0, -11, -69
"c:\Users\edwar\OneDrive\Documents\Programming\Visual Studio 2022\PARTS_Web\app\bot_web\Lib\site-packages\pip\_internal\cli\req_command.py", "Python", 0, 0, 0, -408, 0, -29, -69, -506
"c:\Users\edwar\OneDrive\Documents\Programming\Visual Studio 2022\PARTS_Web\app\bot_web\Lib\site-packages\pip\_internal\cli\spinners.py", "Python", 0, 0, 0, -114, 0, -18, -28, -160
"c:\Users\edwar\OneDrive\Documents\Programming\Visual Studio 2022\PARTS_Web\app\bot_web\Lib\site-packages\pip\_internal\cli\status_codes.py", "Python", 0, 0, 0, -6, 0, 0, -1, -7
"c:\Users\edwar\OneDrive\Documents\Programming\Visual Studio 2022\PARTS_Web\app\bot_web\Lib\site-packages\pip\_internal\commands\__init__.py", "Python", 0, 0, 0, -113, 0, -7, -13, -133
"c:\Users\edwar\OneDrive\Documents\Programming\Visual Studio 2022\PARTS_Web\app\bot_web\Lib\site-packages\pip\_internal\commands\cache.py", "Python", 0, 0, 0, -163, 0, -20, -43, -226
"c:\Users\edwar\OneDrive\Documents\Programming\Visual Studio 2022\PARTS_Web\app\bot_web\Lib\site-packages\pip\_internal\commands\check.py", "Python", 0, 0, 0, -45, 0, 0, -10, -55
"c:\Users\edwar\OneDrive\Documents\Programming\Visual Studio 2022\PARTS_Web\app\bot_web\Lib\site-packages\pip\_internal\commands\completion.py", "Python", 0, 0, 0, -116, 0, -5, -10, -131
"c:\Users\edwar\OneDrive\Documents\Programming\Visual Studio 2022\PARTS_Web\app\bot_web\Lib\site-packages\pip\_internal\commands\configuration.py", "Python", 0, 0, 0, -224, 0, -12, -45, -281
"c:\Users\edwar\OneDrive\Documents\Programming\Visual Studio 2022\PARTS_Web\app\bot_web\Lib\site-packages\pip\_internal\commands\debug.py", "Python", 0, 0, 0, -149, 0, -9, -44, -202
"c:\Users\edwar\OneDrive\Documents\Programming\Visual Studio 2022\PARTS_Web\app\bot_web\Lib\site-packages\pip\_internal\commands\download.py", "Python", 0, 0, 0, -117, 0, -2, -29, -148
"c:\Users\edwar\OneDrive\Documents\Programming\Visual Studio 2022\PARTS_Web\app\bot_web\Lib\site-packages\pip\_internal\commands\freeze.py", "Python", 0, 0, 0, -91, 0, 0, -18, -109
"c:\Users\edwar\OneDrive\Documents\Programming\Visual Studio 2022\PARTS_Web\app\bot_web\Lib\site-packages\pip\_internal\commands\hash.py", "Python", 0, 0, 0, -48, 0, 0, -12, -60
"c:\Users\edwar\OneDrive\Documents\Programming\Visual Studio 2022\PARTS_Web\app\bot_web\Lib\site-packages\pip\_internal\commands\help.py", "Python", 0, 0, 0, -29, 0, -1, -12, -42
"c:\Users\edwar\OneDrive\Documents\Programming\Visual Studio 2022\PARTS_Web\app\bot_web\Lib\site-packages\pip\_internal\commands\index.py", "Python", 0, 0, 0, -108, 0, -4, -28, -140
"c:\Users\edwar\OneDrive\Documents\Programming\Visual Studio 2022\PARTS_Web\app\bot_web\Lib\site-packages\pip\_internal\commands\inspect.py", "Python", 0, 0, 0, -77, 0, -6, -10, -93
"c:\Users\edwar\OneDrive\Documents\Programming\Visual Studio 2022\PARTS_Web\app\bot_web\Lib\site-packages\pip\_internal\commands\install.py", "Python", 0, 0, 0, -646, 0, -36, -93, -775
"c:\Users\edwar\OneDrive\Documents\Programming\Visual Studio 2022\PARTS_Web\app\bot_web\Lib\site-packages\pip\_internal\commands\list.py", "Python", 0, 0, 0, -299, 0, -13, -57, -369
"c:\Users\edwar\OneDrive\Documents\Programming\Visual Studio 2022\PARTS_Web\app\bot_web\Lib\site-packages\pip\_internal\commands\search.py", "Python", 0, 0, 0, -142, 0, -2, -31, -175
"c:\Users\edwar\OneDrive\Documents\Programming\Visual Studio 2022\PARTS_Web\app\bot_web\Lib\site-packages\pip\_internal\commands\show.py", "Python", 0, 0, 0, -162, 0, 0, -28, -190
"c:\Users\edwar\OneDrive\Documents\Programming\Visual Studio 2022\PARTS_Web\app\bot_web\Lib\site-packages\pip\_internal\commands\uninstall.py", "Python", 0, 0, 0, -99, 0, 0, -15, -114
"c:\Users\edwar\OneDrive\Documents\Programming\Visual Studio 2022\PARTS_Web\app\bot_web\Lib\site-packages\pip\_internal\commands\wheel.py", "Python", 0, 0, 0, -151, 0, -2, -31, -184
"c:\Users\edwar\OneDrive\Documents\Programming\Visual Studio 2022\PARTS_Web\app\bot_web\Lib\site-packages\pip\_internal\configuration.py", "Python", 0, 0, 0, -279, 0, -33, -72, -384
"c:\Users\edwar\OneDrive\Documents\Programming\Visual Studio 2022\PARTS_Web\app\bot_web\Lib\site-packages\pip\_internal\distributions\__init__.py", "Python", 0, 0, 0, -13, 0, -4, -5, -22
"c:\Users\edwar\OneDrive\Documents\Programming\Visual Studio 2022\PARTS_Web\app\bot_web\Lib\site-packages\pip\_internal\distributions\base.py", "Python", 0, 0, 0, -38, 0, 0, -14, -52
"c:\Users\edwar\OneDrive\Documents\Programming\Visual Studio 2022\PARTS_Web\app\bot_web\Lib\site-packages\pip\_internal\distributions\installed.py", "Python", 0, 0, 0, -22, 0, 0, -8, -30
"c:\Users\edwar\OneDrive\Documents\Programming\Visual Studio 2022\PARTS_Web\app\bot_web\Lib\site-packages\pip\_internal\distributions\sdist.py", "Python", 0, 0, 0, -122, 0, -18, -17, -157
"c:\Users\edwar\OneDrive\Documents\Programming\Visual Studio 2022\PARTS_Web\app\bot_web\Lib\site-packages\pip\_internal\distributions\wheel.py", "Python", 0, 0, 0, -32, 0, 0, -9, -41
"c:\Users\edwar\OneDrive\Documents\Programming\Visual Studio 2022\PARTS_Web\app\bot_web\Lib\site-packages\pip\_internal\exceptions.py", "Python", 0, 0, 0, -546, 0, -23, -160, -729
"c:\Users\edwar\OneDrive\Documents\Programming\Visual Studio 2022\PARTS_Web\app\bot_web\Lib\site-packages\pip\_internal\index\__init__.py", "Python", 0, 0, 0, -2, 0, 0, -1, -3
"c:\Users\edwar\OneDrive\Documents\Programming\Visual Studio 2022\PARTS_Web\app\bot_web\Lib\site-packages\pip\_internal\index\collector.py", "Python", 0, 0, 0, -393, 0, -29, -86, -508
"c:\Users\edwar\OneDrive\Documents\Programming\Visual Studio 2022\PARTS_Web\app\bot_web\Lib\site-packages\pip\_internal\index\package_finder.py", "Python", 0, 0, 0, -842, 0, -39, -147, -1028
"c:\Users\edwar\OneDrive\Documents\Programming\Visual Studio 2022\PARTS_Web\app\bot_web\Lib\site-packages\pip\_internal\index\sources.py", "Python", 0, 0, 0, -224, 0, -3, -59, -286
"c:\Users\edwar\OneDrive\Documents\Programming\Visual Studio 2022\PARTS_Web\app\bot_web\Lib\site-packages\pip\_internal\locations\__init__.py", "Python", 0, 0, 0, -345, 0, -37, -86, -468
"c:\Users\edwar\OneDrive\Documents\Programming\Visual Studio 2022\PARTS_Web\app\bot_web\Lib\site-packages\pip\_internal\locations\_distutils.py", "Python", 0, 0, 0, -127, 0, -21, -25, -173
"c:\Users\edwar\OneDrive\Documents\Programming\Visual Studio 2022\PARTS_Web\app\bot_web\Lib\site-packages\pip\_internal\locations\_sysconfig.py", "Python", 0, 0, 0, -158, 0, -17, -39, -214
"c:\Users\edwar\OneDrive\Documents\Programming\Visual Studio 2022\PARTS_Web\app\bot_web\Lib\site-packages\pip\_internal\locations\base.py", "Python", 0, 0, 0, -55, 0, -8, -19, -82
"c:\Users\edwar\OneDrive\Documents\Programming\Visual Studio 2022\PARTS_Web\app\bot_web\Lib\site-packages\pip\_internal\main.py", "Python", 0, 0, 0, -8, 0, 0, -5, -13
"c:\Users\edwar\OneDrive\Documents\Programming\Visual Studio 2022\PARTS_Web\app\bot_web\Lib\site-packages\pip\_internal\metadata\__init__.py", "Python", 0, 0, 0, -96, 0, 0, -33, -129
"c:\Users\edwar\OneDrive\Documents\Programming\Visual Studio 2022\PARTS_Web\app\bot_web\Lib\site-packages\pip\_internal\metadata\_json.py", "Python", 0, 0, 0, -68, 0, -6, -11, -85
"c:\Users\edwar\OneDrive\Documents\Programming\Visual Studio 2022\PARTS_Web\app\bot_web\Lib\site-packages\pip\_internal\metadata\base.py", "Python", 0, 0, 0, -564, 0, -15, -124, -703
"c:\Users\edwar\OneDrive\Documents\Programming\Visual Studio 2022\PARTS_Web\app\bot_web\Lib\site-packages\pip\_internal\metadata\importlib\__init__.py", "Python", 0, 0, 0, -4, 0, 0, -3, -7
"c:\Users\edwar\OneDrive\Documents\Programming\Visual Studio 2022\PARTS_Web\app\bot_web\Lib\site-packages\pip\_internal\metadata\importlib\_compat.py", "Python", 0, 0, 0, -40, 0, 0, -16, -56
"c:\Users\edwar\OneDrive\Documents\Programming\Visual Studio 2022\PARTS_Web\app\bot_web\Lib\site-packages\pip\_internal\metadata\importlib\_dists.py", "Python", 0, 0, 0, -184, 0, -12, -32, -228
"c:\Users\edwar\OneDrive\Documents\Programming\Visual Studio 2022\PARTS_Web\app\bot_web\Lib\site-packages\pip\_internal\metadata\importlib\_envs.py", "Python", 0, 0, 0, -150, 0, -6, -34, -190
"c:\Users\edwar\OneDrive\Documents\Programming\Visual Studio 2022\PARTS_Web\app\bot_web\Lib\site-packages\pip\_internal\metadata\pkg_resources.py", "Python", 0, 0, 0, -212, 0, -17, -50, -279
"c:\Users\edwar\OneDrive\Documents\Programming\Visual Studio 2022\PARTS_Web\app\bot_web\Lib\site-packages\pip\_internal\models\__init__.py", "Python", 0, 0, 0, -2, 0, 0, -1, -3
"c:\Users\edwar\OneDrive\Documents\Programming\Visual Studio 2022\PARTS_Web\app\bot_web\Lib\site-packages\pip\_internal\models\candidate.py", "Python", 0, 0, 0, -22, 0, 0, -9, -31
"c:\Users\edwar\OneDrive\Documents\Programming\Visual Studio 2022\PARTS_Web\app\bot_web\Lib\site-packages\pip\_internal\models\direct_url.py", "Python", 0, 0, 0, -190, 0, -3, -43, -236
"c:\Users\edwar\OneDrive\Documents\Programming\Visual Studio 2022\PARTS_Web\app\bot_web\Lib\site-packages\pip\_internal\models\format_control.py", "Python", 0, 0, 0, -63, 0, -1, -15, -79
"c:\Users\edwar\OneDrive\Documents\Programming\Visual Studio 2022\PARTS_Web\app\bot_web\Lib\site-packages\pip\_internal\models\index.py", "Python", 0, 0, 0, -17, 0, -3, -9, -29
"c:\Users\edwar\OneDrive\Documents\Programming\Visual Studio 2022\PARTS_Web\app\bot_web\Lib\site-packages\pip\_internal\models\installation_report.py", "Python", 0, 0, 0, -29, 0, -21, -7, -57
"c:\Users\edwar\OneDrive\Documents\Programming\Visual Studio 2022\PARTS_Web\app\bot_web\Lib\site-packages\pip\_internal\models\link.py", "Python", 0, 0, 0, -427, 0, -54, -99, -580
"c:\Users\edwar\OneDrive\Documents\Programming\Visual Studio 2022\PARTS_Web\app\bot_web\Lib\site-packages\pip\_internal\models\scheme.py", "Python", 0, 0, 0, -24, 0, 0, -8, -32
"c:\Users\edwar\OneDrive\Documents\Programming\Visual Studio 2022\PARTS_Web\app\bot_web\Lib\site-packages\pip\_internal\models\search_scope.py", "Python", 0, 0, 0, -93, 0, -18, -22, -133
"c:\Users\edwar\OneDrive\Documents\Programming\Visual Studio 2022\PARTS_Web\app\bot_web\Lib\site-packages\pip\_internal\models\selection_prefs.py", "Python", 0, 0, 0, -40, 0, -4, -8, -52
"c:\Users\edwar\OneDrive\Documents\Programming\Visual Studio 2022\PARTS_Web\app\bot_web\Lib\site-packages\pip\_internal\models\target_python.py", "Python", 0, 0, 0, -98, 0, -4, -21, -123
"c:\Users\edwar\OneDrive\Documents\Programming\Visual Studio 2022\PARTS_Web\app\bot_web\Lib\site-packages\pip\_internal\models\wheel.py", "Python", 0, 0, 0, -71, 0, -3, -19, -93
"c:\Users\edwar\OneDrive\Documents\Programming\Visual Studio 2022\PARTS_Web\app\bot_web\Lib\site-packages\pip\_internal\network\__init__.py", "Python", 0, 0, 0, -2, 0, 0, -1, -3
"c:\Users\edwar\OneDrive\Documents\Programming\Visual Studio 2022\PARTS_Web\app\bot_web\Lib\site-packages\pip\_internal\network\auth.py", "Python", 0, 0, 0, -387, 0, -71, -104, -562
"c:\Users\edwar\OneDrive\Documents\Programming\Visual Studio 2022\PARTS_Web\app\bot_web\Lib\site-packages\pip\_internal\network\cache.py", "Python", 0, 0, 0, -80, 0, -5, -22, -107
"c:\Users\edwar\OneDrive\Documents\Programming\Visual Studio 2022\PARTS_Web\app\bot_web\Lib\site-packages\pip\_internal\network\download.py", "Python", 0, 0, 0, -150, 0, -3, -34, -187
"c:\Users\edwar\OneDrive\Documents\Programming\Visual Studio 2022\PARTS_Web\app\bot_web\Lib\site-packages\pip\_internal\network\lazy_wheel.py", "Python", 0, 0, 0, -166, 0, -7, -38, -211
"c:\Users\edwar\OneDrive\Documents\Programming\Visual Studio 2022\PARTS_Web\app\bot_web\Lib\site-packages\pip\_internal\network\session.py", "Python", 0, 0, 0, -359, 0, -81, -81, -521
"c:\Users\edwar\OneDrive\Documents\Programming\Visual Studio 2022\PARTS_Web\app\bot_web\Lib\site-packages\pip\_internal\network\utils.py", "Python", 0, 0, 0, -39, 0, -47, -11, -97
"c:\Users\edwar\OneDrive\Documents\Programming\Visual Studio 2022\PARTS_Web\app\bot_web\Lib\site-packages\pip\_internal\network\xmlrpc.py", "Python", 0, 0, 0, -53, 0, 0, -10, -63
"c:\Users\edwar\OneDrive\Documents\Programming\Visual Studio 2022\PARTS_Web\app\bot_web\Lib\site-packages\pip\_internal\operations\__init__.py", "Python", 0, 0, 0, 0, 0, 0, -1, -1
"c:\Users\edwar\OneDrive\Documents\Programming\Visual Studio 2022\PARTS_Web\app\bot_web\Lib\site-packages\pip\_internal\operations\check.py", "Python", 0, 0, 0, -138, 0, -10, -40, -188
"c:\Users\edwar\OneDrive\Documents\Programming\Visual Studio 2022\PARTS_Web\app\bot_web\Lib\site-packages\pip\_internal\operations\freeze.py", "Python", 0, 0, 0, -214, 0, -12, -30, -256
"c:\Users\edwar\OneDrive\Documents\Programming\Visual Studio 2022\PARTS_Web\app\bot_web\Lib\site-packages\pip\_internal\operations\install\__init__.py", "Python", 0, 0, 0, -2, 0, 0, -1, -3
"c:\Users\edwar\OneDrive\Documents\Programming\Visual Studio 2022\PARTS_Web\app\bot_web\Lib\site-packages\pip\_internal\operations\install\editable_legacy.py", "Python", 0, 0, 0, -40, 0, 0, -7, -47
"c:\Users\edwar\OneDrive\Documents\Programming\Visual Studio 2022\PARTS_Web\app\bot_web\Lib\site-packages\pip\_internal\operations\install\wheel.py", "Python", 0, 0, 0, -523, 0, -94, -118, -735
"c:\Users\edwar\OneDrive\Documents\Programming\Visual Studio 2022\PARTS_Web\app\bot_web\Lib\site-packages\pip\_internal\operations\prepare.py", "Python", 0, 0, 0, -529, 0, -113, -89, -731
"c:\Users\edwar\OneDrive\Documents\Programming\Visual Studio 2022\PARTS_Web\app\bot_web\Lib\site-packages\pip\_internal\pyproject.py", "Python", 0, 0, 0, -106, 0, -45, -29, -180
"c:\Users\edwar\OneDrive\Documents\Programming\Visual Studio 2022\PARTS_Web\app\bot_web\Lib\site-packages\pip\_internal\req\__init__.py", "Python", 0, 0, 0, -73, 0, -1, -19, -93
"c:\Users\edwar\OneDrive\Documents\Programming\Visual Studio 2022\PARTS_Web\app\bot_web\Lib\site-packages\pip\_internal\req\constructors.py", "Python", 0, 0, 0, -474, 0, -24, -79, -577
"c:\Users\edwar\OneDrive\Documents\Programming\Visual Studio 2022\PARTS_Web\app\bot_web\Lib\site-packages\pip\_internal\req\req_file.py", "Python", 0, 0, 0, -426, 0, -34, -95, -555
"c:\Users\edwar\OneDrive\Documents\Programming\Visual Studio 2022\PARTS_Web\app\bot_web\Lib\site-packages\pip\_internal\req\req_install.py", "Python", 0, 0, 0, -738, 0, -77, -109, -924
"c:\Users\edwar\OneDrive\Documents\Programming\Visual Studio 2022\PARTS_Web\app\bot_web\Lib\site-packages\pip\_internal\req\req_set.py", "Python", 0, 0, 0, -97, 0, 0, -23, -120
"c:\Users\edwar\OneDrive\Documents\Programming\Visual Studio 2022\PARTS_Web\app\bot_web\Lib\site-packages\pip\_internal\req\req_uninstall.py", "Python", 0, 0, 0, -489, 0, -57, -104, -650
"c:\Users\edwar\OneDrive\Documents\Programming\Visual Studio 2022\PARTS_Web\app\bot_web\Lib\site-packages\pip\_internal\resolution\__init__.py", "Python", 0, 0, 0, 0, 0, 0, -1, -1
"c:\Users\edwar\OneDrive\Documents\Programming\Visual Studio 2022\PARTS_Web\app\bot_web\Lib\site-packages\pip\_internal\resolution\base.py", "Python", 0, 0, 0, -15, 0, 0, -6, -21
"c:\Users\edwar\OneDrive\Documents\Programming\Visual Studio 2022\PARTS_Web\app\bot_web\Lib\site-packages\pip\_internal\resolution\legacy\__init__.py", "Python", 0, 0, 0, 0, 0, 0, -1, -1
"c:\Users\edwar\OneDrive\Documents\Programming\Visual Studio 2022\PARTS_Web\app\bot_web\Lib\site-packages\pip\_internal\resolution\legacy\resolver.py", "Python", 0, 0, 0, -448, 0, -70, -81, -599
"c:\Users\edwar\OneDrive\Documents\Programming\Visual Studio 2022\PARTS_Web\app\bot_web\Lib\site-packages\pip\_internal\resolution\resolvelib\__init__.py", "Python", 0, 0, 0, 0, 0, 0, -1, -1
"c:\Users\edwar\OneDrive\Documents\Programming\Visual Studio 2022\PARTS_Web\app\bot_web\Lib\site-packages\pip\_internal\resolution\resolvelib\base.py", "Python", 0, 0, 0, -103, 0, -4, -35, -142
"c:\Users\edwar\OneDrive\Documents\Programming\Visual Studio 2022\PARTS_Web\app\bot_web\Lib\site-packages\pip\_internal\resolution\resolvelib\candidates.py", "Python", 0, 0, 0, -470, 0, -29, -99, -598
"c:\Users\edwar\OneDrive\Documents\Programming\Visual Studio 2022\PARTS_Web\app\bot_web\Lib\site-packages\pip\_internal\resolution\resolvelib\factory.py", "Python", 0, 0, 0, -656, 0, -77, -80, -813
"c:\Users\edwar\OneDrive\Documents\Programming\Visual Studio 2022\PARTS_Web\app\bot_web\Lib\site-packages\pip\_internal\resolution\resolvelib\found_candidates.py", "Python", 0, 0, 0, -112, 0, -18, -26, -156
"c:\Users\edwar\OneDrive\Documents\Programming\Visual Studio 2022\PARTS_Web\app\bot_web\Lib\site-packages\pip\_internal\resolution\resolvelib\provider.py", "Python", 0, 0, 0, -191, 0, -29, -36, -256
"c:\Users\edwar\OneDrive\Documents\Programming\Visual Studio 2022\PARTS_Web\app\bot_web\Lib\site-packages\pip\_internal\resolution\resolvelib\reporter.py", "Python", 0, 0, 0, -60, 0, -1, -20, -81
"c:\Users\edwar\OneDrive\Documents\Programming\Visual Studio 2022\PARTS_Web\app\bot_web\Lib\site-packages\pip\_internal\resolution\resolvelib\requirements.py", "Python", 0, 0, 0, -110, 0, -12, -45, -167
"c:\Users\edwar\OneDrive\Documents\Programming\Visual Studio 2022\PARTS_Web\app\bot_web\Lib\site-packages\pip\_internal\resolution\resolvelib\resolver.py", "Python", 0, 0, 0, -238, 0, -34, -46, -318
"c:\Users\edwar\OneDrive\Documents\Programming\Visual Studio 2022\PARTS_Web\app\bot_web\Lib\site-packages\pip\_internal\self_outdated_check.py", "Python", 0, 0, 0, -185, 0, -16, -48, -249
"c:\Users\edwar\OneDrive\Documents\Programming\Visual Studio 2022\PARTS_Web\app\bot_web\Lib\site-packages\pip\_internal\utils\__init__.py", "Python", 0, 0, 0, 0, 0, 0, -1, -1
"c:\Users\edwar\OneDrive\Documents\Programming\Visual Studio 2022\PARTS_Web\app\bot_web\Lib\site-packages\pip\_internal\utils\_jaraco_text.py", "Python", 0, 0, 0, -83, 0, 0, -27, -110
"c:\Users\edwar\OneDrive\Documents\Programming\Visual Studio 2022\PARTS_Web\app\bot_web\Lib\site-packages\pip\_internal\utils\_log.py", "Python", 0, 0, 0, -23, 0, -2, -14, -39
"c:\Users\edwar\OneDrive\Documents\Programming\Visual Studio 2022\PARTS_Web\app\bot_web\Lib\site-packages\pip\_internal\utils\appdirs.py", "Python", 0, 0, 0, -31, 0, -5, -17, -53
"c:\Users\edwar\OneDrive\Documents\Programming\Visual Studio 2022\PARTS_Web\app\bot_web\Lib\site-packages\pip\_internal\utils\compat.py", "Python", 0, 0, 0, -36, 0, -9, -19, -64
"c:\Users\edwar\OneDrive\Documents\Programming\Visual Studio 2022\PARTS_Web\app\bot_web\Lib\site-packages\pip\_internal\utils\compatibility_tags.py", "Python", 0, 0, 0, -121, 0, -16, -29, -166
"c:\Users\edwar\OneDrive\Documents\Programming\Visual Studio 2022\PARTS_Web\app\bot_web\Lib\site-packages\pip\_internal\utils\datetime.py", "Python", 0, 0, 0, -7, 0, 0, -5, -12
"c:\Users\edwar\OneDrive\Documents\Programming\Visual Studio 2022\PARTS_Web\app\bot_web\Lib\site-packages\pip\_internal\utils\deprecation.py", "Python", 0, 0, 0, -92, 0, -6, -23, -121
"c:\Users\edwar\OneDrive\Documents\Programming\Visual Studio 2022\PARTS_Web\app\bot_web\Lib\site-packages\pip\_internal\utils\direct_url_helpers.py", "Python", 0, 0, 0, -71, 0, -9, -8, -88
"c:\Users\edwar\OneDrive\Documents\Programming\Visual Studio 2022\PARTS_Web\app\bot_web\Lib\site-packages\pip\_internal\utils\egg_link.py", "Python", 0, 0, 0, -67, 0, 0, -14, -81
"c:\Users\edwar\OneDrive\Documents\Programming\Visual Studio 2022\PARTS_Web\app\bot_web\Lib\site-packages\pip\_internal\utils\encoding.py", "Python", 0, 0, 0, -30, 0, -1, -6, -37
"c:\Users\edwar\OneDrive\Documents\Programming\Visual Studio 2022\PARTS_Web\app\bot_web\Lib\site-packages\pip\_internal\utils\entrypoints.py", "Python", 0, 0, 0, -65, 0, -5, -15, -85
"c:\Users\edwar\OneDrive\Documents\Programming\Visual Studio 2022\PARTS_Web\app\bot_web\Lib\site-packages\pip\_internal\utils\filesystem.py", "Python", 0, 0, 0, -104, 0, -18, -32, -154
"c:\Users\edwar\OneDrive\Documents\Programming\Visual Studio 2022\PARTS_Web\app\bot_web\Lib\site-packages\pip\_internal\utils\filetypes.py", "Python", 0, 0, 0, -22, 0, 0, -6, -28
"c:\Users\edwar\OneDrive\Documents\Programming\Visual Studio 2022\PARTS_Web\app\bot_web\Lib\site-packages\pip\_internal\utils\glibc.py", "Python", 0, 0, 0, -44, 0, -31, -14, -89
"c:\Users\edwar\OneDrive\Documents\Programming\Visual Studio 2022\PARTS_Web\app\bot_web\Lib\site-packages\pip\_internal\utils\hashes.py", "Python", 0, 0, 0, -103, 0, -12, -37, -152
"c:\Users\edwar\OneDrive\Documents\Programming\Visual Studio 2022\PARTS_Web\app\bot_web\Lib\site-packages\pip\_internal\utils\logging.py", "Python", 0, 0, 0, -273, 0, -22, -54, -349
"c:\Users\edwar\OneDrive\Documents\Programming\Visual Studio 2022\PARTS_Web\app\bot_web\Lib\site-packages\pip\_internal\utils\misc.py", "Python", 0, 0, 0, -597, 0, -28, -159, -784
"c:\Users\edwar\OneDrive\Documents\Programming\Visual Studio 2022\PARTS_Web\app\bot_web\Lib\site-packages\pip\_internal\utils\models.py", "Python", 0, 0, 0, -26, 0, 0, -14, -40
"c:\Users\edwar\OneDrive\Documents\Programming\Visual Studio 2022\PARTS_Web\app\bot_web\Lib\site-packages\pip\_internal\utils\packaging.py", "Python", 0, 0, 0, -36, 0, -6, -16, -58
"c:\Users\edwar\OneDrive\Documents\Programming\Visual Studio 2022\PARTS_Web\app\bot_web\Lib\site-packages\pip\_internal\utils\setuptools_build.py", "Python", 0, 0, 0, -106, 0, -16, -25, -147
"c:\Users\edwar\OneDrive\Documents\Programming\Visual Studio 2022\PARTS_Web\app\bot_web\Lib\site-packages\pip\_internal\utils\subprocess.py", "Python", 0, 0, 0, -197, 0, -39, -25, -261
"c:\Users\edwar\OneDrive\Documents\Programming\Visual Studio 2022\PARTS_Web\app\bot_web\Lib\site-packages\pip\_internal\utils\temp_dir.py", "Python", 0, 0, 0, -220, 0, -22, -55, -297
"c:\Users\edwar\OneDrive\Documents\Programming\Visual Studio 2022\PARTS_Web\app\bot_web\Lib\site-packages\pip\_internal\utils\unpacking.py", "Python", 0, 0, 0, -215, 0, -14, -29, -258
"c:\Users\edwar\OneDrive\Documents\Programming\Visual Studio 2022\PARTS_Web\app\bot_web\Lib\site-packages\pip\_internal\utils\urls.py", "Python", 0, 0, 0, -45, 0, -5, -13, -63
"c:\Users\edwar\OneDrive\Documents\Programming\Visual Studio 2022\PARTS_Web\app\bot_web\Lib\site-packages\pip\_internal\utils\virtualenv.py", "Python", 0, 0, 0, -72, 0, -7, -26, -105
"c:\Users\edwar\OneDrive\Documents\Programming\Visual Studio 2022\PARTS_Web\app\bot_web\Lib\site-packages\pip\_internal\utils\wheel.py", "Python", 0, 0, 0, -92, 0, -7, -36, -135
"c:\Users\edwar\OneDrive\Documents\Programming\Visual Studio 2022\PARTS_Web\app\bot_web\Lib\site-packages\pip\_internal\vcs\__init__.py", "Python", 0, 0, 0, -11, 0, -4, -1, -16
"c:\Users\edwar\OneDrive\Documents\Programming\Visual Studio 2022\PARTS_Web\app\bot_web\Lib\site-packages\pip\_internal\vcs\bazaar.py", "Python", 0, 0, 0, -94, 0, -3, -16, -113
"c:\Users\edwar\OneDrive\Documents\Programming\Visual Studio 2022\PARTS_Web\app\bot_web\Lib\site-packages\pip\_internal\vcs\git.py", "Python", 0, 0, 0, -402, 0, -56, -69, -527
"c:\Users\edwar\OneDrive\Documents\Programming\Visual Studio 2022\PARTS_Web\app\bot_web\Lib\site-packages\pip\_internal\vcs\mercurial.py", "Python", 0, 0, 0, -146, 0, -1, -17, -164
"c:\Users\edwar\OneDrive\Documents\Programming\Visual Studio 2022\PARTS_Web\app\bot_web\Lib\site-packages\pip\_internal\vcs\subversion.py", "Python", 0, 0, 0, -237, 0, -40, -48, -325
"c:\Users\edwar\OneDrive\Documents\Programming\Visual Studio 2022\PARTS_Web\app\bot_web\Lib\site-packages\pip\_internal\vcs\versioncontrol.py", "Python", 0, 0, 0, -570, 0, -23, -113, -706
"c:\Users\edwar\OneDrive\Documents\Programming\Visual Studio 2022\PARTS_Web\app\bot_web\Lib\site-packages\pip\_internal\wheel_builder.py", "Python", 0, 0, 0, -290, 0, -19, -46, -355
"c:\Users\edwar\OneDrive\Documents\Programming\Visual Studio 2022\PARTS_Web\app\bot_web\Lib\site-packages\pip\_vendor\__init__.py", "Python", 0, 0, 0, -85, 0, -26, -11, -122
"c:\Users\edwar\OneDrive\Documents\Programming\Visual Studio 2022\PARTS_Web\app\bot_web\Lib\site-packages\pip\_vendor\cachecontrol\__init__.py", "Python", 0, 0, 0, -19, 0, -3, -7, -29
"c:\Users\edwar\OneDrive\Documents\Programming\Visual Studio 2022\PARTS_Web\app\bot_web\Lib\site-packages\pip\_vendor\cachecontrol\_cmd.py", "Python", 0, 0, 0, -43, 0, -7, -21, -71
"c:\Users\edwar\OneDrive\Documents\Programming\Visual Studio 2022\PARTS_Web\app\bot_web\Lib\site-packages\pip\_vendor\cachecontrol\adapter.py", "Python", 0, 0, 0, -114, 0, -20, -28, -162
"c:\Users\edwar\OneDrive\Documents\Programming\Visual Studio 2022\PARTS_Web\app\bot_web\Lib\site-packages\pip\_vendor\cachecontrol\cache.py", "Python", 0, 0, 0, -51, 0, -3, -21, -75
"c:\Users\edwar\OneDrive\Documents\Programming\Visual Studio 2022\PARTS_Web\app\bot_web\Lib\site-packages\pip\_vendor\cachecontrol\caches\__init__.py", "Python", 0, 0, 0, -3, 0, -3, -3, -9
"c:\Users\edwar\OneDrive\Documents\Programming\Visual Studio 2022\PARTS_Web\app\bot_web\Lib\site-packages\pip\_vendor\cachecontrol\caches\file_cache.py", "Python", 0, 0, 0, -122, 0, -23, -37, -182
"c:\Users\edwar\OneDrive\Documents\Programming\Visual Studio 2022\PARTS_Web\app\bot_web\Lib\site-packages\pip\_vendor\cachecontrol\caches\redis_cache.py", "Python", 0, 0, 0, -34, 0, -3, -12, -49
"c:\Users\edwar\OneDrive\Documents\Programming\Visual Studio 2022\PARTS_Web\app\bot_web\Lib\site-packages\pip\_vendor\cachecontrol\controller.py", "Python", 0, 0, 0, -348, 0, -67, -80, -495
"c:\Users\edwar\OneDrive\Documents\Programming\Visual Studio 2022\PARTS_Web\app\bot_web\Lib\site-packages\pip\_vendor\cachecontrol\filewrapper.py", "Python", 0, 0, 0, -68, 0, -29, -23, -120
"c:\Users\edwar\OneDrive\Documents\Programming\Visual Studio 2022\PARTS_Web\app\bot_web\Lib\site-packages\pip\_vendor\cachecontrol\heuristics.py", "Python", 0, 0, 0, -114, 0, -3, -38, -155
"c:\Users\edwar\OneDrive\Documents\Programming\Visual Studio 2022\PARTS_Web\app\bot_web\Lib\site-packages\pip\_vendor\cachecontrol\serialize.py", "Python", 0, 0, 0, -135, 0, -40, -32, -207
"c:\Users\edwar\OneDrive\Documents\Programming\Visual Studio 2022\PARTS_Web\app\bot_web\Lib\site-packages\pip\_vendor\cachecontrol\wrapper.py", "Python", 0, 0, 0, -33, 0, -3, -8, -44
"c:\Users\edwar\OneDrive\Documents\Programming\Visual Studio 2022\PARTS_Web\app\bot_web\Lib\site-packages\pip\_vendor\certifi\__init__.py", "Python", 0, 0, 0, -3, 0, 0, -2, -5
"c:\Users\edwar\OneDrive\Documents\Programming\Visual Studio 2022\PARTS_Web\app\bot_web\Lib\site-packages\pip\_vendor\certifi\__main__.py", "Python", 0, 0, 0, -9, 0, 0, -4, -13
"c:\Users\edwar\OneDrive\Documents\Programming\Visual Studio 2022\PARTS_Web\app\bot_web\Lib\site-packages\pip\_vendor\certifi\core.py", "Python", 0, 0, 0, -51, 0, -37, -21, -109
"c:\Users\edwar\OneDrive\Documents\Programming\Visual Studio 2022\PARTS_Web\app\bot_web\Lib\site-packages\pip\_vendor\chardet\__init__.py", "Python", 0, 0, 0, -84, 0, -19, -13, -116
"c:\Users\edwar\OneDrive\Documents\Programming\Visual Studio 2022\PARTS_Web\app\bot_web\Lib\site-packages\pip\_vendor\chardet\big5freq.py", "Python", 0, 0, 0, -340, 0, -43, -4, -387
"c:\Users\edwar\OneDrive\Documents\Programming\Visual Studio 2022\PARTS_Web\app\bot_web\Lib\site-packages\pip\_vendor\chardet\big5prober.py", "Python", 0, 0, 0, -16, 0, -26, -6, -48
"c:\Users\edwar\OneDrive\Documents\Programming\Visual Studio 2022\PARTS_Web\app\bot_web\Lib\site-packages\pip\_vendor\chardet\chardistribution.py", "Python", 0, 0, 0, -158, 0, -70, -34, -262
"c:\Users\edwar\OneDrive\Documents\Programming\Visual Studio 2022\PARTS_Web\app\bot_web\Lib\site-packages\pip\_vendor\chardet\charsetgroupprober.py", "Python", 0, 0, 0, -71, 0, -26, -10, -107
"c:\Users\edwar\OneDrive\Documents\Programming\Visual Studio 2022\PARTS_Web\app\bot_web\Lib\site-packages\pip\_vendor\chardet\charsetprober.py", "Python", 0, 0, 0, -80, 0, -43, -25, -148
"c:\Users\edwar\OneDrive\Documents\Programming\Visual Studio 2022\PARTS_Web\app\bot_web\Lib\site-packages\pip\_vendor\chardet\cli\__init__.py", "Python", 0, 0, 0, 0, 0, 0, -1, -1
"c:\Users\edwar\OneDrive\Documents\Programming\Visual Studio 2022\PARTS_Web\app\bot_web\Lib\site-packages\pip\_vendor\chardet\cli\chardetect.py", "Python", 0, 0, 0, -94, 0, -2, -17, -113
"c:\Users\edwar\OneDrive\Documents\Programming\Visual Studio 2022\PARTS_Web\app\bot_web\Lib\site-packages\pip\_vendor\chardet\codingstatemachine.py", "Python", 0, 0, 0, -48, 0, -29, -14, -91
"c:\Users\edwar\OneDrive\Documents\Programming\Visual Studio 2022\PARTS_Web\app\bot_web\Lib\site-packages\pip\_vendor\chardet\codingstatemachinedict.py", "Python", 0, 0, 0, -12, 0, -4, -4, -20
"c:\Users\edwar\OneDrive\Documents\Programming\Visual Studio 2022\PARTS_Web\app\bot_web\Lib\site-packages\pip\_vendor\chardet\cp949prober.py", "Python", 0, 0, 0, -16, 0, -28, -6, -50
"c:\Users\edwar\OneDrive\Documents\Programming\Visual Studio 2022\PARTS_Web\app\bot_web\Lib\site-packages\pip\_vendor\chardet\enums.py", "Python", 0, 0, 0, -63, 0, 0, -23, -86
"c:\Users\edwar\OneDrive\Documents\Programming\Visual Studio 2022\PARTS_Web\app\bot_web\Lib\site-packages\pip\_vendor\chardet\escprober.py", "Python", 0, 0, 0, -65, 0, -26, -12, -103
"c:\Users\edwar\OneDrive\Documents\Programming\Visual Studio 2022\PARTS_Web\app\bot_web\Lib\site-packages\pip\_vendor\chardet\escsm.py", "Python", 0, 0, 0, -210, 0, -34, -18, -262
"c:\Users\edwar\OneDrive\Documents\Programming\Visual Studio 2022\PARTS_Web\app\bot_web\Lib\site-packages\pip\_vendor\chardet\eucjpprober.py", "Python", 0, 0, 0, -61, 0, -27, -15, -103
"c:\Users\edwar\OneDrive\Documents\Programming\Visual Studio 2022\PARTS_Web\app\bot_web\Lib\site-packages\pip\_vendor\chardet\euckrfreq.py", "Python", 0, 0, 0, -151, 0, -40, -6, -197
"c:\Users\edwar\OneDrive\Documents\Programming\Visual Studio 2022\PARTS_Web\app\bot_web\Lib\site-packages\pip\_vendor\chardet\euckrprober.py", "Python", 0, 0, 0, -16, 0, -26, -6, -48
"c:\Users\edwar\OneDrive\Documents\Programming\Visual Studio 2022\PARTS_Web\app\bot_web\Lib\site-packages\pip\_vendor\chardet\euctwfreq.py", "Python", 0, 0, 0, -340, 0, -43, -6, -389
"c:\Users\edwar\OneDrive\Documents\Programming\Visual Studio 2022\PARTS_Web\app\bot_web\Lib\site-packages\pip\_vendor\chardet\euctwprober.py", "Python", 0, 0, 0, -16, 0, -26, -6, -48
"c:\Users\edwar\OneDrive\Documents\Programming\Visual Studio 2022\PARTS_Web\app\bot_web\Lib\site-packages\pip\_vendor\chardet\gb2312freq.py", "Python", 0, 0, 0, -239, 0, -40, -6, -285
"c:\Users\edwar\OneDrive\Documents\Programming\Visual Studio 2022\PARTS_Web\app\bot_web\Lib\site-packages\pip\_vendor\chardet\gb2312prober.py", "Python", 0, 0, 0, -16, 0, -26, -6, -48
"c:\Users\edwar\OneDrive\Documents\Programming\Visual Studio 2022\PARTS_Web\app\bot_web\Lib\site-packages\pip\_vendor\chardet\hebrewprober.py", "Python", 0, 0, 0, -103, 0, -186, -28, -317
"c:\Users\edwar\OneDrive\Documents\Programming\Visual Studio 2022\PARTS_Web\app\bot_web\Lib\site-packages\pip\_vendor\chardet\jisfreq.py", "Python", 0, 0, 0, -277, 0, -43, -6, -326
"c:\Users\edwar\OneDrive\Documents\Programming\Visual Studio 2022\PARTS_Web\app\bot_web\Lib\site-packages\pip\_vendor\chardet\johabfreq.py", "Python", 0, 0, 0, -2352, 0, -28, -3, -2383
"c:\Users\edwar\OneDrive\Documents\Programming\Visual Studio 2022\PARTS_Web\app\bot_web\Lib\site-packages\pip\_vendor\chardet\johabprober.py", "Python", 0, 0, 0, -16, 0, -26, -6, -48
"c:\Users\edwar\OneDrive\Documents\Programming\Visual Studio 2022\PARTS_Web\app\bot_web\Lib\site-packages\pip\_vendor\chardet\jpcntx.py", "Python", 0, 0, 0, -171, 0, -46, -22, -239
"c:\Users\edwar\OneDrive\Documents\Programming\Visual Studio 2022\PARTS_Web\app\bot_web\Lib\site-packages\pip\_vendor\chardet\langbulgarianmodel.py", "Python", 0, 0, 0, -4632, 0, -10, -8, -4650
"c:\Users\edwar\OneDrive\Documents\Programming\Visual Studio 2022\PARTS_Web\app\bot_web\Lib\site-packages\pip\_vendor\chardet\langgreekmodel.py", "Python", 0, 0, 0, -4380, 0, -10, -8, -4398
"c:\Users\edwar\OneDrive\Documents\Programming\Visual Studio 2022\PARTS_Web\app\bot_web\Lib\site-packages\pip\_vendor\chardet\langhebrewmodel.py", "Python", 0, 0, 0, -4365, 0, -10, -6, -4381
"c:\Users\edwar\OneDrive\Documents\Programming\Visual Studio 2022\PARTS_Web\app\bot_web\Lib\site-packages\pip\_vendor\chardet\langhungarianmodel.py", "Python", 0, 0, 0, -4632, 0, -10, -8, -4650
"c:\Users\edwar\OneDrive\Documents\Programming\Visual Studio 2022\PARTS_Web\app\bot_web\Lib\site-packages\pip\_vendor\chardet\langrussianmodel.py", "Python", 0, 0, 0, -5700, 0, -10, -16, -5726
"c:\Users\edwar\OneDrive\Documents\Programming\Visual Studio 2022\PARTS_Web\app\bot_web\Lib\site-packages\pip\_vendor\chardet\langthaimodel.py", "Python", 0, 0, 0, -4365, 0, -10, -6, -4381
"c:\Users\edwar\OneDrive\Documents\Programming\Visual Studio 2022\PARTS_Web\app\bot_web\Lib\site-packages\pip\_vendor\chardet\langturkishmodel.py", "Python", 0, 0, 0, -4365, 0, -10, -6, -4381
"c:\Users\edwar\OneDrive\Documents\Programming\Visual Studio 2022\PARTS_Web\app\bot_web\Lib\site-packages\pip\_vendor\chardet\latin1prober.py", "Python", 0, 0, 0, -96, 0, -36, -16, -148
"c:\Users\edwar\OneDrive\Documents\Programming\Visual Studio 2022\PARTS_Web\app\bot_web\Lib\site-packages\pip\_vendor\chardet\macromanprober.py", "Python", 0, 0, 0, -99, 0, -45, -19, -163
"c:\Users\edwar\OneDrive\Documents\Programming\Visual Studio 2022\PARTS_Web\app\bot_web\Lib\site-packages\pip\_vendor\chardet\mbcharsetprober.py", "Python", 0, 0, 0, -55, 0, -28, -13, -96
"c:\Users\edwar\OneDrive\Documents\Programming\Visual Studio 2022\PARTS_Web\app\bot_web\Lib\site-packages\pip\_vendor\chardet\mbcsgroupprober.py", "Python", 0, 0, 0, -26, 0, -28, -4, -58
"c:\Users\edwar\OneDrive\Documents\Programming\Visual Studio 2022\PARTS_Web\app\bot_web\Lib\site-packages\pip\_vendor\chardet\mbcssm.py", "Python", 0, 0, 0, -547, 0, -68, -47, -662
"c:\Users\edwar\OneDrive\Documents\Programming\Visual Studio 2022\PARTS_Web\app\bot_web\Lib\site-packages\pip\_vendor\chardet\metadata\__init__.py", "Python", 0, 0, 0, 0, 0, 0, -1, -1
"c:\Users\edwar\OneDrive\Documents\Programming\Visual Studio 2022\PARTS_Web\app\bot_web\Lib\site-packages\pip\_vendor\chardet\metadata\languages.py", "Python", 0, 0, 0, -308, 0, -34, -11, -353
"c:\Users\edwar\OneDrive\Documents\Programming\Visual Studio 2022\PARTS_Web\app\bot_web\Lib\site-packages\pip\_vendor\chardet\resultdict.py", "Python", 0, 0, 0, -9, 0, -4, -4, -17
"c:\Users\edwar\OneDrive\Documents\Programming\Visual Studio 2022\PARTS_Web\app\bot_web\Lib\site-packages\pip\_vendor\chardet\sbcharsetprober.py", "Python", 0, 0, 0, -108, 0, -40, -15, -163
"c:\Users\edwar\OneDrive\Documents\Programming\Visual Studio 2022\PARTS_Web\app\bot_web\Lib\site-packages\pip\_vendor\chardet\sbcsgroupprober.py", "Python", 0, 0, 0, -45, 0, -39, -5, -89
"c:\Users\edwar\OneDrive\Documents\Programming\Visual Studio 2022\PARTS_Web\app\bot_web\Lib\site-packages\pip\_vendor\chardet\sjisprober.py", "Python", 0, 0, 0, -65, 0, -26, -15, -106
"c:\Users\edwar\OneDrive\Documents\Programming\Visual Studio 2022\PARTS_Web\app\bot_web\Lib\site-packages\pip\_vendor\chardet\universaldetector.py", "Python", 0, 0, 0, -265, 0, -63, -35, -363
"c:\Users\edwar\OneDrive\Documents\Programming\Visual Studio 2022\PARTS_Web\app\bot_web\Lib\site-packages\pip\_vendor\chardet\utf1632prober.py", "Python", 0, 0, 0, -175, 0, -26, -25, -226
"c:\Users\edwar\OneDrive\Documents\Programming\Visual Studio 2022\PARTS_Web\app\bot_web\Lib\site-packages\pip\_vendor\chardet\utf8prober.py", "Python", 0, 0, 0, -44, 0, -26, -13, -83
"c:\Users\edwar\OneDrive\Documents\Programming\Visual Studio 2022\PARTS_Web\app\bot_web\Lib\site-packages\pip\_vendor\chardet\version.py", "Python", 0, 0, 0, -7, 0, 0, -3, -10
"c:\Users\edwar\OneDrive\Documents\Programming\Visual Studio 2022\PARTS_Web\app\bot_web\Lib\site-packages\pip\_vendor\colorama\__init__.py", "Python", 0, 0, 0, -4, 0, -1, -3, -8
"c:\Users\edwar\OneDrive\Documents\Programming\Visual Studio 2022\PARTS_Web\app\bot_web\Lib\site-packages\pip\_vendor\colorama\ansi.py", "Python", 0, 0, 0, -77, 0, -6, -20, -103
"c:\Users\edwar\OneDrive\Documents\Programming\Visual Studio 2022\PARTS_Web\app\bot_web\Lib\site-packages\pip\_vendor\colorama\ansitowin32.py", "Python", 0, 0, 0, -209, 0, -25, -44, -278
"c:\Users\edwar\OneDrive\Documents\Programming\Visual Studio 2022\PARTS_Web\app\bot_web\Lib\site-packages\pip\_vendor\colorama\initialise.py", "Python", 0, 0, 0, -83, 0, -8, -31, -122
"c:\Users\edwar\OneDrive\Documents\Programming\Visual Studio 2022\PARTS_Web\app\bot_web\Lib\site-packages\pip\_vendor\colorama\tests\__init__.py", "Python", 0, 0, 0, 0, 0, -1, -1, -2
"c:\Users\edwar\OneDrive\Documents\Programming\Visual Studio 2022\PARTS_Web\app\bot_web\Lib\site-packages\pip\_vendor\colorama\tests\ansi_test.py", "Python", 0, 0, 0, -55, 0, -5, -17, -77
"c:\Users\edwar\OneDrive\Documents\Programming\Visual Studio 2022\PARTS_Web\app\bot_web\Lib\site-packages\pip\_vendor\colorama\tests\ansitowin32_test.py", "Python", 0, 0, 0, -243, 0, -8, -44, -295
"c:\Users\edwar\OneDrive\Documents\Programming\Visual Studio 2022\PARTS_Web\app\bot_web\Lib\site-packages\pip\_vendor\colorama\tests\initialise_test.py", "Python", 0, 0, 0, -145, 0, -10, -35, -190
"c:\Users\edwar\OneDrive\Documents\Programming\Visual Studio 2022\PARTS_Web\app\bot_web\Lib\site-packages\pip\_vendor\colorama\tests\isatty_test.py", "Python", 0, 0, 0, -43, 0, -1, -14, -58
"c:\Users\edwar\OneDrive\Documents\Programming\Visual Studio 2022\PARTS_Web\app\bot_web\Lib\site-packages\pip\_vendor\colorama\tests\utils.py", "Python", 0, 0, 0, -41, 0, -1, -8, -50
"c:\Users\edwar\OneDrive\Documents\Programming\Visual Studio 2022\PARTS_Web\app\bot_web\Lib\site-packages\pip\_vendor\colorama\tests\winterm_test.py", "Python", 0, 0, 0, -99, 0, -1, -32, -132
"c:\Users\edwar\OneDrive\Documents\Programming\Visual Studio 2022\PARTS_Web\app\bot_web\Lib\site-packages\pip\_vendor\colorama\win32.py", "Python", 0, 0, 0, -146, 0, -10, -25, -181
"c:\Users\edwar\OneDrive\Documents\Programming\Visual Studio 2022\PARTS_Web\app\bot_web\Lib\site-packages\pip\_vendor\colorama\winterm.py", "Python", 0, 0, 0, -143, 0, -29, -24, -196
"c:\Users\edwar\OneDrive\Documents\Programming\Visual Studio 2022\PARTS_Web\app\bot_web\Lib\site-packages\pip\_vendor\distlib\__init__.py", "Python", 0, 0, 0, -16, 0, -6, -12, -34
"c:\Users\edwar\OneDrive\Documents\Programming\Visual Studio 2022\PARTS_Web\app\bot_web\Lib\site-packages\pip\_vendor\distlib\compat.py", "Python", 0, 0, 0, -861, 0, -101, -177, -1139
"c:\Users\edwar\OneDrive\Documents\Programming\Visual Studio 2022\PARTS_Web\app\bot_web\Lib\site-packages\pip\_vendor\distlib\database.py", "Python", 0, 0, 0, -1135, 0, -45, -180, -1360
"c:\Users\edwar\OneDrive\Documents\Programming\Visual Studio 2022\PARTS_Web\app\bot_web\Lib\site-packages\pip\_vendor\distlib\index.py", "Python", 0, 0, 0, -445, 0, -19, -45, -509
"c:\Users\edwar\OneDrive\Documents\Programming\Visual Studio 2022\PARTS_Web\app\bot_web\Lib\site-packages\pip\_vendor\distlib\locators.py", "Python", 0, 0, 0, -1107, 0, -77, -120, -1304
"c:\Users\edwar\OneDrive\Documents\Programming\Visual Studio 2022\PARTS_Web\app\bot_web\Lib\site-packages\pip\_vendor\distlib\manifest.py", "Python", 0, 0, 0, -276, 0, -40, -69, -385
"c:\Users\edwar\OneDrive\Documents\Programming\Visual Studio 2022\PARTS_Web\app\bot_web\Lib\site-packages\pip\_vendor\distlib\markers.py", "Python", 0, 0, 0, -129, 0, -9, -30, -168
"c:\Users\edwar\OneDrive\Documents\Programming\Visual Studio 2022\PARTS_Web\app\bot_web\Lib\site-packages\pip\_vendor\distlib\metadata.py", "Python", 0, 0, 0, -840, 0, -74, -155, -1069
"c:\Users\edwar\OneDrive\Documents\Programming\Visual Studio 2022\PARTS_Web\app\bot_web\Lib\site-packages\pip\_vendor\distlib\resources.py", "Python", 0, 0, 0, -280, 0, -15, -64, -359
"c:\Users\edwar\OneDrive\Documents\Programming\Visual Studio 2022\PARTS_Web\app\bot_web\Lib\site-packages\pip\_vendor\distlib\scripts.py", "Python", 0, 0, 0, -359, 0, -48, -46, -453
"c:\Users\edwar\OneDrive\Documents\Programming\Visual Studio 2022\PARTS_Web\app\bot_web\Lib\site-packages\pip\_vendor\distlib\util.py", "Python", 0, 0, 0, -1564, 0, -167, -295, -2026
"c:\Users\edwar\OneDrive\Documents\Programming\Visual Studio 2022\PARTS_Web\app\bot_web\Lib\site-packages\pip\_vendor\distlib\version.py", "Python", 0, 0, 0, -533, 0, -86, -133, -752
"c:\Users\edwar\OneDrive\Documents\Programming\Visual Studio 2022\PARTS_Web\app\bot_web\Lib\site-packages\pip\_vendor\distlib\wheel.py", "Python", 0, 0, 0, -902, 0, -81, -117, -1100
"c:\Users\edwar\OneDrive\Documents\Programming\Visual Studio 2022\PARTS_Web\app\bot_web\Lib\site-packages\pip\_vendor\distro\__init__.py", "Python", 0, 0, 0, -52, 0, 0, -3, -55
"c:\Users\edwar\OneDrive\Documents\Programming\Visual Studio 2022\PARTS_Web\app\bot_web\Lib\site-packages\pip\_vendor\distro\__main__.py", "Python", 0, 0, 0, -3, 0, 0, -2, -5
"c:\Users\edwar\OneDrive\Documents\Programming\Visual Studio 2022\PARTS_Web\app\bot_web\Lib\site-packages\pip\_vendor\distro\distro.py", "Python", 0, 0, 0, -1035, 0, -90, -275, -1400
"c:\Users\edwar\OneDrive\Documents\Programming\Visual Studio 2022\PARTS_Web\app\bot_web\Lib\site-packages\pip\_vendor\idna\__init__.py", "Python", 0, 0, 0, -43, 0, 0, -2, -45
"c:\Users\edwar\OneDrive\Documents\Programming\Visual Studio 2022\PARTS_Web\app\bot_web\Lib\site-packages\pip\_vendor\idna\codec.py", "Python", 0, 0, 0, -84, 0, -4, -25, -113
"c:\Users\edwar\OneDrive\Documents\Programming\Visual Studio 2022\PARTS_Web\app\bot_web\Lib\site-packages\pip\_vendor\idna\compat.py", "Python", 0, 0, 0, -9, 0, 0, -5, -14
"c:\Users\edwar\OneDrive\Documents\Programming\Visual Studio 2022\PARTS_Web\app\bot_web\Lib\site-packages\pip\_vendor\idna\core.py", "Python", 0, 0, 0, -319, 0, -8, -74, -401
"c:\Users\edwar\OneDrive\Documents\Programming\Visual Studio 2022\PARTS_Web\app\bot_web\Lib\site-packages\pip\_vendor\idna\idnadata.py", "Python", 0, 0, 0, -2149, 0, -1, -2, -2152
"c:\Users\edwar\OneDrive\Documents\Programming\Visual Studio 2022\PARTS_Web\app\bot_web\Lib\site-packages\pip\_vendor\idna\intranges.py", "Python", 0, 0, 0, -42, 0, -3, -10, -55
"c:\Users\edwar\OneDrive\Documents\Programming\Visual Studio 2022\PARTS_Web\app\bot_web\Lib\site-packages\pip\_vendor\idna\package_data.py", "Python", 0, 0, 0, -1, 0, 0, -2, -3
"c:\Users\edwar\OneDrive\Documents\Programming\Visual Studio 2022\PARTS_Web\app\bot_web\Lib\site-packages\pip\_vendor\idna\uts46data.py", "Python", 0, 0, 0, -8511, 0, -2, -88, -8601
"c:\Users\edwar\OneDrive\Documents\Programming\Visual Studio 2022\PARTS_Web\app\bot_web\Lib\site-packages\pip\_vendor\msgpack\__init__.py", "Python", 0, 0, 0, -38, 0, -2, -18, -58
"c:\Users\edwar\OneDrive\Documents\Programming\Visual Studio 2022\PARTS_Web\app\bot_web\Lib\site-packages\pip\_vendor\msgpack\exceptions.py", "Python", 0, 0, 0, -28, 0, -2, -19, -49
"c:\Users\edwar\OneDrive\Documents\Programming\Visual Studio 2022\PARTS_Web\app\bot_web\Lib\site-packages\pip\_vendor\msgpack\ext.py", "Python", 0, 0, 0, -149, 0, -4, -41, -194
"c:\Users\edwar\OneDrive\Documents\Programming\Visual Studio 2022\PARTS_Web\app\bot_web\Lib\site-packages\pip\_vendor\msgpack\fallback.py", "Python", 0, 0, 0, -857, 0, -22, -132, -1011
"c:\Users\edwar\OneDrive\Documents\Programming\Visual Studio 2022\PARTS_Web\app\bot_web\Lib\site-packages\pip\_vendor\packaging\__about__.py", "Python", 0, 0, 0, -18, 0, -3, -6, -27
"c:\Users\edwar\OneDrive\Documents\Programming\Visual Studio 2022\PARTS_Web\app\bot_web\Lib\site-packages\pip\_vendor\packaging\__init__.py", "Python", 0, 0, 0, -20, 0, -3, -3, -26
"c:\Users\edwar\OneDrive\Documents\Programming\Visual Studio 2022\PARTS_Web\app\bot_web\Lib\site-packages\pip\_vendor\packaging\_manylinux.py", "Python", 0, 0, 0, -212, 0, -51, -39, -302
"c:\Users\edwar\OneDrive\Documents\Programming\Visual Studio 2022\PARTS_Web\app\bot_web\Lib\site-packages\pip\_vendor\packaging\_musllinux.py", "Python", 0, 0, 0, -107, 0, -4, -26, -137
"c:\Users\edwar\OneDrive\Documents\Programming\Visual Studio 2022\PARTS_Web\app\bot_web\Lib\site-packages\pip\_vendor\packaging\_structures.py", "Python", 0, 0, 0, -36, 0, -3, -23, -62
"c:\Users\edwar\OneDrive\Documents\Programming\Visual Studio 2022\PARTS_Web\app\bot_web\Lib\site-packages\pip\_vendor\packaging\markers.py", "Python", 0, 0, 0, -224, 0, -7, -74, -305
"c:\Users\edwar\OneDrive\Documents\Programming\Visual Studio 2022\PARTS_Web\app\bot_web\Lib\site-packages\pip\_vendor\packaging\requirements.py", "Python", 0, 0, 0, -105, 0, -9, -33, -147
"c:\Users\edwar\OneDrive\Documents\Programming\Visual Studio 2022\PARTS_Web\app\bot_web\Lib\site-packages\pip\_vendor\packaging\specifiers.py", "Python", 0, 0, 0, -490, 0, -156, -157, -803
"c:\Users\edwar\OneDrive\Documents\Programming\Visual Studio 2022\PARTS_Web\app\bot_web\Lib\site-packages\pip\_vendor\packaging\tags.py", "Python", 0, 0, 0, -373, 0, -26, -89, -488
"c:\Users\edwar\OneDrive\Documents\Programming\Visual Studio 2022\PARTS_Web\app\bot_web\Lib\site-packages\pip\_vendor\packaging\utils.py", "Python", 0, 0, 0, -91, 0, -16, -30, -137
"c:\Users\edwar\OneDrive\Documents\Programming\Visual Studio 2022\PARTS_Web\app\bot_web\Lib\site-packages\pip\_vendor\packaging\version.py", "Python", 0, 0, 0, -334, 0, -58, -113, -505
"c:\Users\edwar\OneDrive\Documents\Programming\Visual Studio 2022\PARTS_Web\app\bot_web\Lib\site-packages\pip\_vendor\pkg_resources\__init__.py", "Python", 0, 0, 0, -2548, 0, -154, -660, -3362
"c:\Users\edwar\OneDrive\Documents\Programming\Visual Studio 2022\PARTS_Web\app\bot_web\Lib\site-packages\pip\_vendor\platformdirs\__init__.py", "Python", 0, 0, 0, -495, 0, 0, -72, -567
"c:\Users\edwar\OneDrive\Documents\Programming\Visual Studio 2022\PARTS_Web\app\bot_web\Lib\site-packages\pip\_vendor\platformdirs\__main__.py", "Python", 0, 0, 0, -42, 0, 0, -12, -54
"c:\Users\edwar\OneDrive\Documents\Programming\Visual Studio 2022\PARTS_Web\app\bot_web\Lib\site-packages\pip\_vendor\platformdirs\android.py", "Python", 0, 0, 0, -160, 0, -7, -44, -211
"c:\Users\edwar\OneDrive\Documents\Programming\Visual Studio 2022\PARTS_Web\app\bot_web\Lib\site-packages\pip\_vendor\platformdirs\api.py", "Python", 0, 0, 0, -186, 0, 0, -38, -224
"c:\Users\edwar\OneDrive\Documents\Programming\Visual Studio 2022\PARTS_Web\app\bot_web\Lib\site-packages\pip\_vendor\platformdirs\macos.py", "Python", 0, 0, 0, -71, 0, 0, -21, -92
"c:\Users\edwar\OneDrive\Documents\Programming\Visual Studio 2022\PARTS_Web\app\bot_web\Lib\site-packages\pip\_vendor\platformdirs\unix.py", "Python", 0, 0, 0, -180, 0, -5, -39, -224
"c:\Users\edwar\OneDrive\Documents\Programming\Visual Studio 2022\PARTS_Web\app\bot_web\Lib\site-packages\pip\_vendor\platformdirs\version.py", "Python", 0, 0, 0, -2, 0, -2, -1, -5
"c:\Users\edwar\OneDrive\Documents\Programming\Visual Studio 2022\PARTS_Web\app\bot_web\Lib\site-packages\pip\_vendor\platformdirs\windows.py", "Python", 0, 0, 0, -206, 0, -4, -46, -256
"c:\Users\edwar\OneDrive\Documents\Programming\Visual Studio 2022\PARTS_Web\app\bot_web\Lib\site-packages\pip\_vendor\pygments\__init__.py", "Python", 0, 0, 0, -65, 0, -2, -16, -83
"c:\Users\edwar\OneDrive\Documents\Programming\Visual Studio 2022\PARTS_Web\app\bot_web\Lib\site-packages\pip\_vendor\pygments\__main__.py", "Python", 0, 0, 0, -13, 0, 0, -5, -18
"c:\Users\edwar\OneDrive\Documents\Programming\Visual Studio 2022\PARTS_Web\app\bot_web\Lib\site-packages\pip\_vendor\pygments\cmdline.py", "Python", 0, 0, 0, -554, 0, -39, -76, -669
"c:\Users\edwar\OneDrive\Documents\Programming\Visual Studio 2022\PARTS_Web\app\bot_web\Lib\site-packages\pip\_vendor\pygments\console.py", "Python", 0, 0, 0, -54, 0, 0, -17, -71
"c:\Users\edwar\OneDrive\Documents\Programming\Visual Studio 2022\PARTS_Web\app\bot_web\Lib\site-packages\pip\_vendor\pygments\filter.py", "Python", 0, 0, 0, -55, 0, -1, -16, -72
"c:\Users\edwar\OneDrive\Documents\Programming\Visual Studio 2022\PARTS_Web\app\bot_web\Lib\site-packages\pip\_vendor\pygments\filters\__init__.py", "Python", 0, 0, 0, -858, 0, -3, -80, -941
"c:\Users\edwar\OneDrive\Documents\Programming\Visual Studio 2022\PARTS_Web\app\bot_web\Lib\site-packages\pip\_vendor\pygments\formatter.py", "Python", 0, 0, 0, -88, 0, -10, -27, -125
"c:\Users\edwar\OneDrive\Documents\Programming\Visual Studio 2022\PARTS_Web\app\bot_web\Lib\site-packages\pip\_vendor\pygments\formatters\__init__.py", "Python", 0, 0, 0, -123, 0, -4, -32, -159
"c:\Users\edwar\OneDrive\Documents\Programming\Visual Studio 2022\PARTS_Web\app\bot_web\Lib\site-packages\pip\_vendor\pygments\formatters\_mapping.py", "Python", 0, 0, 0, -20, 0, -2, -2, -24
"c:\Users\edwar\OneDrive\Documents\Programming\Visual Studio 2022\PARTS_Web\app\bot_web\Lib\site-packages\pip\_vendor\pygments\formatters\bbcode.py", "Python", 0, 0, 0, -85, 0, -1, -23, -109
"c:\Users\edwar\OneDrive\Documents\Programming\Visual Studio 2022\PARTS_Web\app\bot_web\Lib\site-packages\pip\_vendor\pygments\formatters\groff.py", "Python", 0, 0, 0, -128, 0, 0, -43, -171
"c:\Users\edwar\OneDrive\Documents\Programming\Visual Studio 2022\PARTS_Web\app\bot_web\Lib\site-packages\pip\_vendor\pygments\formatters\html.py", "Python", 0, 0, 0, -789, 0, -23, -178, -990
"c:\Users\edwar\OneDrive\Documents\Programming\Visual Studio 2022\PARTS_Web\app\bot_web\Lib\site-packages\pip\_vendor\pygments\formatters\img.py", "Python", 0, 0, 0, -520, 0, -22, -104, -646
"c:\Users\edwar\OneDrive\Documents\Programming\Visual Studio 2022\PARTS_Web\app\bot_web\Lib\site-packages\pip\_vendor\pygments\formatters\irc.py", "Python", 0, 0, 0, -126, 0, -4, -25, -155
"c:\Users\edwar\OneDrive\Documents\Programming\Visual Studio 2022\PARTS_Web\app\bot_web\Lib\site-packages\pip\_vendor\pygments\formatters\latex.py", "Python", 0, 0, 0, -405, 0, -45, -72, -522
"c:\Users\edwar\OneDrive\Documents\Programming\Visual Studio 2022\PARTS_Web\app\bot_web\Lib\site-packages\pip\_vendor\pygments\formatters\other.py", "Python", 0, 0, 0, -129, 0, -3, -30, -162
"c:\Users\edwar\OneDrive\Documents\Programming\Visual Studio 2022\PARTS_Web\app\bot_web\Lib\site-packages\pip\_vendor\pygments\formatters\pangomarkup.py", "Python", 0, 0, 0, -62, 0, 0, -22, -84
"c:\Users\edwar\OneDrive\Documents\Programming\Visual Studio 2022\PARTS_Web\app\bot_web\Lib\site-packages\pip\_vendor\pygments\formatters\rtf.py", "Python", 0, 0, 0, -111, 0, -9, -27, -147
"c:\Users\edwar\OneDrive\Documents\Programming\Visual Studio 2022\PARTS_Web\app\bot_web\Lib\site-packages\pip\_vendor\pygments\formatters\svg.py", "Python", 0, 0, 0, -156, 0, 0, -33, -189
"c:\Users\edwar\OneDrive\Documents\Programming\Visual Studio 2022\PARTS_Web\app\bot_web\Lib\site-packages\pip\_vendor\pygments\formatters\terminal.py", "Python", 0, 0, 0, -97, 0, -5, -26, -128
"c:\Users\edwar\OneDrive\Documents\Programming\Visual Studio 2022\PARTS_Web\app\bot_web\Lib\site-packages\pip\_vendor\pygments\formatters\terminal256.py", "Python", 0, 0, 0, -255, 0, -21, -63, -339
"c:\Users\edwar\OneDrive\Documents\Programming\Visual Studio 2022\PARTS_Web\app\bot_web\Lib\site-packages\pip\_vendor\pygments\lexer.py", "Python", 0, 0, 0, -719, 0, -85, -140, -944
"c:\Users\edwar\OneDrive\Documents\Programming\Visual Studio 2022\PARTS_Web\app\bot_web\Lib\site-packages\pip\_vendor\pygments\lexers\__init__.py", "Python", 0, 0, 0, -275, 0, -22, -66, -363
"c:\Users\edwar\OneDrive\Documents\Programming\Visual Studio 2022\PARTS_Web\app\bot_web\Lib\site-packages\pip\_vendor\pygments\lexers\_mapping.py", "Python", 0, 0, 0, -556, 0, -2, -2, -560
"c:\Users\edwar\OneDrive\Documents\Programming\Visual Studio 2022\PARTS_Web\app\bot_web\Lib\site-packages\pip\_vendor\pygments\lexers\python.py", "Python", 0, 0, 0, -1056, 0, -67, -76, -1199
"c:\Users\edwar\OneDrive\Documents\Programming\Visual Studio 2022\PARTS_Web\app\bot_web\Lib\site-packages\pip\_vendor\pygments\modeline.py", "Python", 0, 0, 0, -32, 0, 0, -12, -44
"c:\Users\edwar\OneDrive\Documents\Programming\Visual Studio 2022\PARTS_Web\app\bot_web\Lib\site-packages\pip\_vendor\pygments\plugin.py", "Python", 0, 0, 0, -61, 0, -4, -24, -89
"c:\Users\edwar\OneDrive\Documents\Programming\Visual Studio 2022\PARTS_Web\app\bot_web\Lib\site-packages\pip\_vendor\pygments\regexopt.py", "Python", 0, 0, 0, -66, 0, -13, -13, -92
"c:\Users\edwar\OneDrive\Documents\Programming\Visual Studio 2022\PARTS_Web\app\bot_web\Lib\site-packages\pip\_vendor\pygments\scanner.py", "Python", 0, 0, 0, -89, 0, 0, -16, -105
"c:\Users\edwar\OneDrive\Documents\Programming\Visual Studio 2022\PARTS_Web\app\bot_web\Lib\site-packages\pip\_vendor\pygments\sphinxext.py", "Python", 0, 0, 0, -174, 0, 0, -44, -218
"c:\Users\edwar\OneDrive\Documents\Programming\Visual Studio 2022\PARTS_Web\app\bot_web\Lib\site-packages\pip\_vendor\pygments\style.py", "Python", 0, 0, 0, -153, 0, -17, -28, -198
"c:\Users\edwar\OneDrive\Documents\Programming\Visual Studio 2022\PARTS_Web\app\bot_web\Lib\site-packages\pip\_vendor\pygments\styles\__init__.py", "Python", 0, 0, 0, -90, 0, -3, -11, -104
"c:\Users\edwar\OneDrive\Documents\Programming\Visual Studio 2022\PARTS_Web\app\bot_web\Lib\site-packages\pip\_vendor\pygments\token.py", "Python", 0, 0, 0, -164, 0, -12, -38, -214
"c:\Users\edwar\OneDrive\Documents\Programming\Visual Studio 2022\PARTS_Web\app\bot_web\Lib\site-packages\pip\_vendor\pygments\unistring.py", "Python", 0, 0, 0, -94, 0, -6, -54, -154
"c:\Users\edwar\OneDrive\Documents\Programming\Visual Studio 2022\PARTS_Web\app\bot_web\Lib\site-packages\pip\_vendor\pygments\util.py", "Python", 0, 0, 0, -269, 0, -5, -57, -331
"c:\Users\edwar\OneDrive\Documents\Programming\Visual Studio 2022\PARTS_Web\app\bot_web\Lib\site-packages\pip\_vendor\pyparsing\__init__.py", "Python", 0, 0, 0, -268, 0, -26, -29, -323
"c:\Users\edwar\OneDrive\Documents\Programming\Visual Studio 2022\PARTS_Web\app\bot_web\Lib\site-packages\pip\_vendor\pyparsing\actions.py", "Python", 0, 0, 0, -151, 0, -8, -59, -218
"c:\Users\edwar\OneDrive\Documents\Programming\Visual Studio 2022\PARTS_Web\app\bot_web\Lib\site-packages\pip\_vendor\pyparsing\common.py", "Python", 0, 0, 0, -312, 0, -39, -82, -433
"c:\Users\edwar\OneDrive\Documents\Programming\Visual Studio 2022\PARTS_Web\app\bot_web\Lib\site-packages\pip\_vendor\pyparsing\core.py", "Python", 0, 0, 0, -4805, 0, -271, -1040, -6116
"c:\Users\edwar\OneDrive\Documents\Programming\Visual Studio 2022\PARTS_Web\app\bot_web\Lib\site-packages\pip\_vendor\pyparsing\diagram\__init__.py", "Python", 0, 0, 0, -517, 0, -59, -81, -657
"c:\Users\edwar\OneDrive\Documents\Programming\Visual Studio 2022\PARTS_Web\app\bot_web\Lib\site-packages\pip\_vendor\pyparsing\exceptions.py", "Python", 0, 0, 0, -232, 0, -7, -61, -300
"c:\Users\edwar\OneDrive\Documents\Programming\Visual Studio 2022\PARTS_Web\app\bot_web\Lib\site-packages\pip\_vendor\pyparsing\helpers.py", "Python", 0, 0, 0, -871, 0, -41, -189, -1101
"c:\Users\edwar\OneDrive\Documents\Programming\Visual Studio 2022\PARTS_Web\app\bot_web\Lib\site-packages\pip\_vendor\pyparsing\results.py", "Python", 0, 0, 0, -642, 0, -26, -129, -797
"c:\Users\edwar\OneDrive\Documents\Programming\Visual Studio 2022\PARTS_Web\app\bot_web\Lib\site-packages\pip\_vendor\pyparsing\testing.py", "Python", 0, 0, 0, -279, 0, -10, -43, -332
"c:\Users\edwar\OneDrive\Documents\Programming\Visual Studio 2022\PARTS_Web\app\bot_web\Lib\site-packages\pip\_vendor\pyparsing\unicode.py", "Python", 0, 0, 0, -307, 0, -5, -50, -362
"c:\Users\edwar\OneDrive\Documents\Programming\Visual Studio 2022\PARTS_Web\app\bot_web\Lib\site-packages\pip\_vendor\pyparsing\util.py", "Python", 0, 0, 0, -212, 0, -13, -60, -285
"c:\Users\edwar\OneDrive\Documents\Programming\Visual Studio 2022\PARTS_Web\app\bot_web\Lib\site-packages\pip\_vendor\pyproject_hooks\__init__.py", "Python", 0, 0, 0, -21, 0, 0, -3, -24
"c:\Users\edwar\OneDrive\Documents\Programming\Visual Studio 2022\PARTS_Web\app\bot_web\Lib\site-packages\pip\_vendor\pyproject_hooks\_compat.py", "Python", 0, 0, 0, -6, 0, 0, -3, -9
"c:\Users\edwar\OneDrive\Documents\Programming\Visual Studio 2022\PARTS_Web\app\bot_web\Lib\site-packages\pip\_vendor\pyproject_hooks\_impl.py", "Python", 0, 0, 0, -258, 0, -4, -69, -331
"c:\Users\edwar\OneDrive\Documents\Programming\Visual Studio 2022\PARTS_Web\app\bot_web\Lib\site-packages\pip\_vendor\pyproject_hooks\_in_process\__init__.py", "Python", 0, 0, 0, -14, 0, -1, -4, -19
"c:\Users\edwar\OneDrive\Documents\Programming\Visual Studio 2022\PARTS_Web\app\bot_web\Lib\site-packages\pip\_vendor\pyproject_hooks\_in_process\_in_process.py", "Python", 0, 0, 0, -274, 0, -6, -74, -354
"c:\Users\edwar\OneDrive\Documents\Programming\Visual Studio 2022\PARTS_Web\app\bot_web\Lib\site-packages\pip\_vendor\requests\__init__.py", "Python", 0, 0, 0, -128, 0, -21, -34, -183
"c:\Users\edwar\OneDrive\Documents\Programming\Visual Studio 2022\PARTS_Web\app\bot_web\Lib\site-packages\pip\_vendor\requests\__version__.py", "Python", 0, 0, 0, -10, 0, -3, -2, -15
"c:\Users\edwar\OneDrive\Documents\Programming\Visual Studio 2022\PARTS_Web\app\bot_web\Lib\site-packages\pip\_vendor\requests\_internal_utils.py", "Python", 0, 0, 0, -40, 0, 0, -11, -51
"c:\Users\edwar\OneDrive\Documents\Programming\Visual Studio 2022\PARTS_Web\app\bot_web\Lib\site-packages\pip\_vendor\requests\adapters.py", "Python", 0, 0, 0, -432, 0, -13, -94, -539
"c:\Users\edwar\OneDrive\Documents\Programming\Visual Studio 2022\PARTS_Web\app\bot_web\Lib\site-packages\pip\_vendor\requests\api.py", "Python", 0, 0, 0, -117, 0, -3, -38, -158
"c:\Users\edwar\OneDrive\Documents\Programming\Visual Studio 2022\PARTS_Web\app\bot_web\Lib\site-packages\pip\_vendor\requests\auth.py", "Python", 0, 0, 0, -223, 0, -27, -66, -316
"c:\Users\edwar\OneDrive\Documents\Programming\Visual Studio 2022\PARTS_Web\app\bot_web\Lib\site-packages\pip\_vendor\requests\certs.py", "Python", 0, 0, 0, -17, 0, -1, -7, -25
"c:\Users\edwar\OneDrive\Documents\Programming\Visual Studio 2022\PARTS_Web\app\bot_web\Lib\site-packages\pip\_vendor\requests\compat.py", "Python", 0, 0, 0, -44, 0, -12, -12, -68
"c:\Users\edwar\OneDrive\Documents\Programming\Visual Studio 2022\PARTS_Web\app\bot_web\Lib\site-packages\pip\_vendor\requests\cookies.py", "Python", 0, 0, 0, -439, 0, -12, -111, -562
"c:\Users\edwar\OneDrive\Documents\Programming\Visual Studio 2022\PARTS_Web\app\bot_web\Lib\site-packages\pip\_vendor\requests\exceptions.py", "Python", 0, 0, 0, -82, 0, -1, -59, -142
"c:\Users\edwar\OneDrive\Documents\Programming\Visual Studio 2022\PARTS_Web\app\bot_web\Lib\site-packages\pip\_vendor\requests\help.py", "Python", 0, 0, 0, -109, 0, 0, -23, -132
"c:\Users\edwar\OneDrive\Documents\Programming\Visual Studio 2022\PARTS_Web\app\bot_web\Lib\site-packages\pip\_vendor\requests\hooks.py", "Python", 0, 0, 0, -23, 0, -1, -10, -34
"c:\Users\edwar\OneDrive\Documents\Programming\Visual Studio 2022\PARTS_Web\app\bot_web\Lib\site-packages\pip\_vendor\requests\models.py", "Python", 0, 0, 0, -737, 0, -114, -184, -1035
"c:\Users\edwar\OneDrive\Documents\Programming\Visual Studio 2022\PARTS_Web\app\bot_web\Lib\site-packages\pip\_vendor\requests\packages.py", "Python", 0, 0, 0, -8, 0, -5, -4, -17
"c:\Users\edwar\OneDrive\Documents\Programming\Visual Studio 2022\PARTS_Web\app\bot_web\Lib\site-packages\pip\_vendor\requests\sessions.py", "Python", 0, 0, 0, -564, 0, -116, -154, -834
"c:\Users\edwar\OneDrive\Documents\Programming\Visual Studio 2022\PARTS_Web\app\bot_web\Lib\site-packages\pip\_vendor\requests\status_codes.py", "Python", 0, 0, 0, -112, 0, -4, -13, -129
"c:\Users\edwar\OneDrive\Documents\Programming\Visual Studio 2022\PARTS_Web\app\bot_web\Lib\site-packages\pip\_vendor\requests\structures.py", "Python", 0, 0, 0, -67, 0, -5, -28, -100
"c:\Users\edwar\OneDrive\Documents\Programming\Visual Studio 2022\PARTS_Web\app\bot_web\Lib\site-packages\pip\_vendor\requests\utils.py", "Python", 0, 0, 0, -775, 0, -86, -234, -1095
"c:\Users\edwar\OneDrive\Documents\Programming\Visual Studio 2022\PARTS_Web\app\bot_web\Lib\site-packages\pip\_vendor\resolvelib\__init__.py", "Python", 0, 0, 0, -23, 0, 0, -4, -27
"c:\Users\edwar\OneDrive\Documents\Programming\Visual Studio 2022\PARTS_Web\app\bot_web\Lib\site-packages\pip\_vendor\resolvelib\compat\__init__.py", "Python", 0, 0, 0, 0, 0, 0, -1, -1
"c:\Users\edwar\OneDrive\Documents\Programming\Visual Studio 2022\PARTS_Web\app\bot_web\Lib\site-packages\pip\_vendor\resolvelib\compat\collections_abc.py", "Python", 0, 0, 0, -5, 0, 0, -2, -7
"c:\Users\edwar\OneDrive\Documents\Programming\Visual Studio 2022\PARTS_Web\app\bot_web\Lib\site-packages\pip\_vendor\resolvelib\providers.py", "Python", 0, 0, 0, -105, 0, 0, -29, -134
"c:\Users\edwar\OneDrive\Documents\Programming\Visual Studio 2022\PARTS_Web\app\bot_web\Lib\site-packages\pip\_vendor\resolvelib\reporters.py", "Python", 0, 0, 0, -31, 0, 0, -13, -44
"c:\Users\edwar\OneDrive\Documents\Programming\Visual Studio 2022\PARTS_Web\app\bot_web\Lib\site-packages\pip\_vendor\resolvelib\resolvers.py", "Python", 0, 0, 0, -417, 0, -33, -98, -548
"c:\Users\edwar\OneDrive\Documents\Programming\Visual Studio 2022\PARTS_Web\app\bot_web\Lib\site-packages\pip\_vendor\resolvelib\structs.py", "Python", 0, 0, 0, -127, 0, 0, -44, -171
"c:\Users\edwar\OneDrive\Documents\Programming\Visual Studio 2022\PARTS_Web\app\bot_web\Lib\site-packages\pip\_vendor\rich\__init__.py", "Python", 0, 0, 0, -142, 0, -3, -33, -178
"c:\Users\edwar\OneDrive\Documents\Programming\Visual Studio 2022\PARTS_Web\app\bot_web\Lib\site-packages\pip\_vendor\rich\__main__.py", "Python", 0, 0, 0, -234, 0, -2, -39, -275
"c:\Users\edwar\OneDrive\Documents\Programming\Visual Studio 2022\PARTS_Web\app\bot_web\Lib\site-packages\pip\_vendor\rich\_cell_widths.py", "Python", 0, 0, 0, -449, 0, -1, -2, -452
"c:\Users\edwar\OneDrive\Documents\Programming\Visual Studio 2022\PARTS_Web\app\bot_web\Lib\site-packages\pip\_vendor\rich\_emoji_codes.py", "Python", 0, 0, 0, -3610, 0, 0, -1, -3611
"c:\Users\edwar\OneDrive\Documents\Programming\Visual Studio 2022\PARTS_Web\app\bot_web\Lib\site-packages\pip\_vendor\rich\_emoji_replace.py", "Python", 0, 0, 0, -25, 0, 0, -8, -33
"c:\Users\edwar\OneDrive\Documents\Programming\Visual Studio 2022\PARTS_Web\app\bot_web\Lib\site-packages\pip\_vendor\rich\_export_format.py", "Python", 0, 0, 0, -68, 0, 0, -9, -77
"c:\Users\edwar\OneDrive\Documents\Programming\Visual Studio 2022\PARTS_Web\app\bot_web\Lib\site-packages\pip\_vendor\rich\_extension.py", "Python", 0, 0, 0, -6, 0, -1, -4, -11
"c:\Users\edwar\OneDrive\Documents\Programming\Visual Studio 2022\PARTS_Web\app\bot_web\Lib\site-packages\pip\_vendor\rich\_fileno.py", "Python", 0, 0, 0, -16, 0, -3, -6, -25
"c:\Users\edwar\OneDrive\Documents\Programming\Visual Studio 2022\PARTS_Web\app\bot_web\Lib\site-packages\pip\_vendor\rich\_inspect.py", "Python", 0, 0, 0, -227, 0, -4, -40, -271
"c:\Users\edwar\OneDrive\Documents\Programming\Visual Studio 2022\PARTS_Web\app\bot_web\Lib\site-packages\pip\_vendor\rich\_log_render.py", "Python", 0, 0, 0, -81, 0, 0, -14, -95
"c:\Users\edwar\OneDrive\Documents\Programming\Visual Studio 2022\PARTS_Web\app\bot_web\Lib\site-packages\pip\_vendor\rich\_loop.py", "Python", 0, 0, 0, -36, 0, 0, -8, -44
"c:\Users\edwar\OneDrive\Documents\Programming\Visual Studio 2022\PARTS_Web\app\bot_web\Lib\site-packages\pip\_vendor\rich\_null_file.py", "Python", 0, 0, 0, -47, 0, 0, -23, -70
"c:\Users\edwar\OneDrive\Documents\Programming\Visual Studio 2022\PARTS_Web\app\bot_web\Lib\site-packages\pip\_vendor\rich\_palettes.py", "Python", 0, 0, 0, -301, 0, -3, -6, -310
"c:\Users\edwar\OneDrive\Documents\Programming\Visual Studio 2022\PARTS_Web\app\bot_web\Lib\site-packages\pip\_vendor\rich\_pick.py", "Python", 0, 0, 0, -13, 0, 0, -5, -18
"c:\Users\edwar\OneDrive\Documents\Programming\Visual Studio 2022\PARTS_Web\app\bot_web\Lib\site-packages\pip\_vendor\rich\_ratio.py", "Python", 0, 0, 0, -122, 0, -12, -27, -161
"c:\Users\edwar\OneDrive\Documents\Programming\Visual Studio 2022\PARTS_Web\app\bot_web\Lib\site-packages\pip\_vendor\rich\_spinners.py", "Python", 0, 0, 0, -481, 0, 0, -2, -483
"c:\Users\edwar\OneDrive\Documents\Programming\Visual Studio 2022\PARTS_Web\app\bot_web\Lib\site-packages\pip\_vendor\rich\_stack.py", "Python", 0, 0, 0, -11, 0, 0, -6, -17
"c:\Users\edwar\OneDrive\Documents\Programming\Visual Studio 2022\PARTS_Web\app\bot_web\Lib\site-packages\pip\_vendor\rich\_timer.py", "Python", 0, 0, 0, -14, 0, 0, -6, -20
"c:\Users\edwar\OneDrive\Documents\Programming\Visual Studio 2022\PARTS_Web\app\bot_web\Lib\site-packages\pip\_vendor\rich\_win32_console.py", "Python", 0, 0, 0, -527, 0, -4, -132, -663
"c:\Users\edwar\OneDrive\Documents\Programming\Visual Studio 2022\PARTS_Web\app\bot_web\Lib\site-packages\pip\_vendor\rich\_windows.py", "Python", 0, 0, 0, -55, 0, -1, -17, -73
"c:\Users\edwar\OneDrive\Documents\Programming\Visual Studio 2022\PARTS_Web\app\bot_web\Lib\site-packages\pip\_vendor\rich\_windows_renderer.py", "Python", 0, 0, 0, -52, 0, 0, -5, -57
"c:\Users\edwar\OneDrive\Documents\Programming\Visual Studio 2022\PARTS_Web\app\bot_web\Lib\site-packages\pip\_vendor\rich\_wrap.py", "Python", 0, 0, 0, -46, 0, 0, -11, -57
"c:\Users\edwar\OneDrive\Documents\Programming\Visual Studio 2022\PARTS_Web\app\bot_web\Lib\site-packages\pip\_vendor\rich\abc.py", "Python", 0, 0, 0, -22, 0, 0, -12, -34
"c:\Users\edwar\OneDrive\Documents\Programming\Visual Studio 2022\PARTS_Web\app\bot_web\Lib\site-packages\pip\_vendor\rich\align.py", "Python", 0, 0, 0, -270, 0, -4, -38, -312
"c:\Users\edwar\OneDrive\Documents\Programming\Visual Studio 2022\PARTS_Web\app\bot_web\Lib\site-packages\pip\_vendor\rich\ansi.py", "Python", 0, 0, 0, -201, 0, -6, -34, -241
"c:\Users\edwar\OneDrive\Documents\Programming\Visual Studio 2022\PARTS_Web\app\bot_web\Lib\site-packages\pip\_vendor\rich\bar.py", "Python", 0, 0, 0, -71, 0, -5, -19, -95
"c:\Users\edwar\OneDrive\Documents\Programming\Visual Studio 2022\PARTS_Web\app\bot_web\Lib\site-packages\pip\_vendor\rich\box.py", "Python", 0, 0, 0, -418, 0, -11, -89, -518
"c:\Users\edwar\OneDrive\Documents\Programming\Visual Studio 2022\PARTS_Web\app\bot_web\Lib\site-packages\pip\_vendor\rich\cells.py", "Python", 0, 0, 0, -117, 0, -4, -34, -155
"c:\Users\edwar\OneDrive\Documents\Programming\Visual Studio 2022\PARTS_Web\app\bot_web\Lib\site-packages\pip\_vendor\rich\color.py", "Python", 0, 0, 0, -544, 0, -3, -76, -623
"c:\Users\edwar\OneDrive\Documents\Programming\Visual Studio 2022\PARTS_Web\app\bot_web\Lib\site-packages\pip\_vendor\rich\color_triplet.py", "Python", 0, 0, 0, -30, 0, 0, -9, -39
"c:\Users\edwar\OneDrive\Documents\Programming\Visual Studio 2022\PARTS_Web\app\bot_web\Lib\site-packages\pip\_vendor\rich\columns.py", "Python", 0, 0, 0, -166, 0, -1, -21, -188
"c:\Users\edwar\OneDrive\Documents\Programming\Visual Studio 2022\PARTS_Web\app\bot_web\Lib\site-packages\pip\_vendor\rich\console.py", "Python", 0, 0, 0, -2244, 0, -19, -371, -2634
"c:\Users\edwar\OneDrive\Documents\Programming\Visual Studio 2022\PARTS_Web\app\bot_web\Lib\site-packages\pip\_vendor\rich\constrain.py", "Python", 0, 0, 0, -29, 0, 0, -9, -38
"c:\Users\edwar\OneDrive\Documents\Programming\Visual Studio 2022\PARTS_Web\app\bot_web\Lib\site-packages\pip\_vendor\rich\containers.py", "Python", 0, 0, 0, -139, 0, 0, -29, -168
"c:\Users\edwar\OneDrive\Documents\Programming\Visual Studio 2022\PARTS_Web\app\bot_web\Lib\site-packages\pip\_vendor\rich\control.py", "Python", 0, 0, 0, -180, 0, -1, -45, -226
"c:\Users\edwar\OneDrive\Documents\Programming\Visual Studio 2022\PARTS_Web\app\bot_web\Lib\site-packages\pip\_vendor\rich\default_styles.py", "Python", 0, 0, 0, -181, 0, 0, -10, -191
"c:\Users\edwar\OneDrive\Documents\Programming\Visual Studio 2022\PARTS_Web\app\bot_web\Lib\site-packages\pip\_vendor\rich\diagnose.py", "Python", 0, 0, 0, -30, 0, 0, -8, -38
"c:\Users\edwar\OneDrive\Documents\Programming\Visual Studio 2022\PARTS_Web\app\bot_web\Lib\site-packages\pip\_vendor\rich\emoji.py", "Python", 0, 0, 0, -70, 0, 0, -27, -97
"c:\Users\edwar\OneDrive\Documents\Programming\Visual Studio 2022\PARTS_Web\app\bot_web\Lib\site-packages\pip\_vendor\rich\errors.py", "Python", 0, 0, 0, -18, 0, 0, -17, -35
"c:\Users\edwar\OneDrive\Documents\Programming\Visual Studio 2022\PARTS_Web\app\bot_web\Lib\site-packages\pip\_vendor\rich\file_proxy.py", "Python", 0, 0, 0, -47, 0, 0, -11, -58
"c:\Users\edwar\OneDrive\Documents\Programming\Visual Studio 2022\PARTS_Web\app\bot_web\Lib\site-packages\pip\_vendor\rich\filesize.py", "Python", 0, 0, 0, -70, 0, -1, -19, -90
"c:\Users\edwar\OneDrive\Documents\Programming\Visual Studio 2022\PARTS_Web\app\bot_web\Lib\site-packages\pip\_vendor\rich\highlighter.py", "Python", 0, 0, 0, -151, 0, -37, -45, -233
"c:\Users\edwar\OneDrive\Documents\Programming\Visual Studio 2022\PARTS_Web\app\bot_web\Lib\site-packages\pip\_vendor\rich\json.py", "Python", 0, 0, 0, -123, 0, 0, -18, -141
"c:\Users\edwar\OneDrive\Documents\Programming\Visual Studio 2022\PARTS_Web\app\bot_web\Lib\site-packages\pip\_vendor\rich\jupyter.py", "Python", 0, 0, 0, -77, 0, -2, -23, -102
"c:\Users\edwar\OneDrive\Documents\Programming\Visual Studio 2022\PARTS_Web\app\bot_web\Lib\site-packages\pip\_vendor\rich\layout.py", "Python", 0, 0, 0, -358, 0, 0, -86, -444
"c:\Users\edwar\OneDrive\Documents\Programming\Visual Studio 2022\PARTS_Web\app\bot_web\Lib\site-packages\pip\_vendor\rich\live.py", "Python", 0, 0, 0, -321, 0, -6, -49, -376
"c:\Users\edwar\OneDrive\Documents\Programming\Visual Studio 2022\PARTS_Web\app\bot_web\Lib\site-packages\pip\_vendor\rich\live_render.py", "Python", 0, 0, 0, -95, 0, 0, -19, -114
"c:\Users\edwar\OneDrive\Documents\Programming\Visual Studio 2022\PARTS_Web\app\bot_web\Lib\site-packages\pip\_vendor\rich\logging.py", "Python", 0, 0, 0, -253, 0, -4, -33, -290
"c:\Users\edwar\OneDrive\Documents\Programming\Visual Studio 2022\PARTS_Web\app\bot_web\Lib\site-packages\pip\_vendor\rich\markup.py", "Python", 0, 0, 0, -197, 0, -3, -47, -247
"c:\Users\edwar\OneDrive\Documents\Programming\Visual Studio 2022\PARTS_Web\app\bot_web\Lib\site-packages\pip\_vendor\rich\measure.py", "Python", 0, 0, 0, -126, 0, 0, -26, -152
"c:\Users\edwar\OneDrive\Documents\Programming\Visual Studio 2022\PARTS_Web\app\bot_web\Lib\site-packages\pip\_vendor\rich\padding.py", "Python", 0, 0, 0, -121, 0, 0, -21, -142
"c:\Users\edwar\OneDrive\Documents\Programming\Visual Studio 2022\PARTS_Web\app\bot_web\Lib\site-packages\pip\_vendor\rich\pager.py", "Python", 0, 0, 0, -23, 0, 0, -12, -35
"c:\Users\edwar\OneDrive\Documents\Programming\Visual Studio 2022\PARTS_Web\app\bot_web\Lib\site-packages\pip\_vendor\rich\palette.py", "Python", 0, 0, 0, -82, 0, -1, -18, -101
"c:\Users\edwar\OneDrive\Documents\Programming\Visual Studio 2022\PARTS_Web\app\bot_web\Lib\site-packages\pip\_vendor\rich\panel.py", "Python", 0, 0, 0, -277, 0, 0, -32, -309
"c:\Users\edwar\OneDrive\Documents\Programming\Visual Studio 2022\PARTS_Web\app\bot_web\Lib\site-packages\pip\_vendor\rich\pretty.py", "Python", 0, 0, 0, -862, 0, -15, -118, -995
"c:\Users\edwar\OneDrive\Documents\Programming\Visual Studio 2022\PARTS_Web\app\bot_web\Lib\site-packages\pip\_vendor\rich\progress.py", "Python", 0, 0, 0, -1434, 0, -10, -259, -1703
"c:\Users\edwar\OneDrive\Documents\Programming\Visual Studio 2022\PARTS_Web\app\bot_web\Lib\site-packages\pip\_vendor\rich\progress_bar.py", "Python", 0, 0, 0, -193, 0, -1, -31, -225
"c:\Users\edwar\OneDrive\Documents\Programming\Visual Studio 2022\PARTS_Web\app\bot_web\Lib\site-packages\pip\_vendor\rich\prompt.py", "Python", 0, 0, 0, -295, 0, 0, -82, -377
"c:\Users\edwar\OneDrive\Documents\Programming\Visual Studio 2022\PARTS_Web\app\bot_web\Lib\site-packages\pip\_vendor\rich\protocol.py", "Python", 0, 0, 0, -31, 0, -1, -11, -43
"c:\Users\edwar\OneDrive\Documents\Programming\Visual Studio 2022\PARTS_Web\app\bot_web\Lib\site-packages\pip\_vendor\rich\region.py", "Python", 0, 0, 0, -7, 0, 0, -4, -11
"c:\Users\edwar\OneDrive\Documents\Programming\Visual Studio 2022\PARTS_Web\app\bot_web\Lib\site-packages\pip\_vendor\rich\repr.py", "Python", 0, 0, 0, -116, 0, 0, -34, -150
"c:\Users\edwar\OneDrive\Documents\Programming\Visual Studio 2022\PARTS_Web\app\bot_web\Lib\site-packages\pip\_vendor\rich\rule.py", "Python", 0, 0, 0, -109, 0, 0, -22, -131
"c:\Users\edwar\OneDrive\Documents\Programming\Visual Studio 2022\PARTS_Web\app\bot_web\Lib\site-packages\pip\_vendor\rich\scope.py", "Python", 0, 0, 0, -73, 0, 0, -14, -87
"c:\Users\edwar\OneDrive\Documents\Programming\Visual Studio 2022\PARTS_Web\app\bot_web\Lib\site-packages\pip\_vendor\rich\screen.py", "Python", 0, 0, 0, -44, 0, 0, -11, -55
"c:\Users\edwar\OneDrive\Documents\Programming\Visual Studio 2022\PARTS_Web\app\bot_web\Lib\site-packages\pip\_vendor\rich\segment.py", "Python", 0, 0, 0, -624, 0, -1, -115, -740
"c:\Users\edwar\OneDrive\Documents\Programming\Visual Studio 2022\PARTS_Web\app\bot_web\Lib\site-packages\pip\_vendor\rich\spinner.py", "Python", 0, 0, 0, -115, 0, 0, -23, -138
"c:\Users\edwar\OneDrive\Documents\Programming\Visual Studio 2022\PARTS_Web\app\bot_web\Lib\site-packages\pip\_vendor\rich\status.py", "Python", 0, 0, 0, -113, 0, 0, -20, -133
"c:\Users\edwar\OneDrive\Documents\Programming\Visual Studio 2022\PARTS_Web\app\bot_web\Lib\site-packages\pip\_vendor\rich\style.py", "Python", 0, 0, 0, -696, 0, -2, -99, -797
"c:\Users\edwar\OneDrive\Documents\Programming\Visual Studio 2022\PARTS_Web\app\bot_web\Lib\site-packages\pip\_vendor\rich\styled.py", "Python", 0, 0, 0, -31, 0, 0, -12, -43
"c:\Users\edwar\OneDrive\Documents\Programming\Visual Studio 2022\PARTS_Web\app\bot_web\Lib\site-packages\pip\_vendor\rich\syntax.py", "Python", 0, 0, 0, -831, 0, -13, -105, -949
"c:\Users\edwar\OneDrive\Documents\Programming\Visual Studio 2022\PARTS_Web\app\bot_web\Lib\site-packages\pip\_vendor\rich\table.py", "Python", 0, 0, 0, -878, 0, -4, -121, -1003
"c:\Users\edwar\OneDrive\Documents\Programming\Visual Studio 2022\PARTS_Web\app\bot_web\Lib\site-packages\pip\_vendor\rich\terminal_theme.py", "Python", 0, 0, 0, -143, 0, 0, -11, -154
"c:\Users\edwar\OneDrive\Documents\Programming\Visual Studio 2022\PARTS_Web\app\bot_web\Lib\site-packages\pip\_vendor\rich\text.py", "Python", 0, 0, 0, -1117, 0, -5, -186, -1308
"c:\Users\edwar\OneDrive\Documents\Programming\Visual Studio 2022\PARTS_Web\app\bot_web\Lib\site-packages\pip\_vendor\rich\theme.py", "Python", 0, 0, 0, -91, 0, 0, -25, -116
"c:\Users\edwar\OneDrive\Documents\Programming\Visual Studio 2022\PARTS_Web\app\bot_web\Lib\site-packages\pip\_vendor\rich\themes.py", "Python", 0, 0, 0, -3, 0, 0, -3, -6
"c:\Users\edwar\OneDrive\Documents\Programming\Visual Studio 2022\PARTS_Web\app\bot_web\Lib\site-packages\pip\_vendor\rich\traceback.py", "Python", 0, 0, 0, -656, 0, -16, -85, -757
"c:\Users\edwar\OneDrive\Documents\Programming\Visual Studio 2022\PARTS_Web\app\bot_web\Lib\site-packages\pip\_vendor\rich\tree.py", "Python", 0, 0, 0, -215, 0, -1, -36, -252
"c:\Users\edwar\OneDrive\Documents\Programming\Visual Studio 2022\PARTS_Web\app\bot_web\Lib\site-packages\pip\_vendor\six.py", "Python", 0, 0, 0, -755, 0, -53, -191, -999
"c:\Users\edwar\OneDrive\Documents\Programming\Visual Studio 2022\PARTS_Web\app\bot_web\Lib\site-packages\pip\_vendor\tenacity\__init__.py", "Python", 0, 0, 0, -461, 0, -41, -107, -609
"c:\Users\edwar\OneDrive\Documents\Programming\Visual Studio 2022\PARTS_Web\app\bot_web\Lib\site-packages\pip\_vendor\tenacity\_asyncio.py", "Python", 0, 0, 0, -61, 0, -18, -16, -95
"c:\Users\edwar\OneDrive\Documents\Programming\Visual Studio 2022\PARTS_Web\app\bot_web\Lib\site-packages\pip\_vendor\tenacity\_utils.py", "Python", 0, 0, 0, -43, 0, -19, -15, -77
"c:\Users\edwar\OneDrive\Documents\Programming\Visual Studio 2022\PARTS_Web\app\bot_web\Lib\site-packages\pip\_vendor\tenacity\after.py", "Python", 0, 0, 0, -25, 0, -16, -11, -52
"c:\Users\edwar\OneDrive\Documents\Programming\Visual Studio 2022\PARTS_Web\app\bot_web\Lib\site-packages\pip\_vendor\tenacity\before.py", "Python", 0, 0, 0, -20, 0, -16, -11, -47
"c:\Users\edwar\OneDrive\Documents\Programming\Visual Studio 2022\PARTS_Web\app\bot_web\Lib\site-packages\pip\_vendor\tenacity\before_sleep.py", "Python", 0, 0, 0, -39, 0, -16, -17, -72
"c:\Users\edwar\OneDrive\Documents\Programming\Visual Studio 2022\PARTS_Web\app\bot_web\Lib\site-packages\pip\_vendor\tenacity\nap.py", "Python", 0, 0, 0, -16, 0, -18, -10, -44
"c:\Users\edwar\OneDrive\Documents\Programming\Visual Studio 2022\PARTS_Web\app\bot_web\Lib\site-packages\pip\_vendor\tenacity\retry.py", "Python", 0, 0, 0, -178, 0, -18, -77, -273
"c:\Users\edwar\OneDrive\Documents\Programming\Visual Studio 2022\PARTS_Web\app\bot_web\Lib\site-packages\pip\_vendor\tenacity\stop.py", "Python", 0, 0, 0, -53, 0, -15, -36, -104
"c:\Users\edwar\OneDrive\Documents\Programming\Visual Studio 2022\PARTS_Web\app\bot_web\Lib\site-packages\pip\_vendor\tenacity\tornadoweb.py", "Python", 0, 0, 0, -37, 0, -13, -10, -60
"c:\Users\edwar\OneDrive\Documents\Programming\Visual Studio 2022\PARTS_Web\app\bot_web\Lib\site-packages\pip\_vendor\tenacity\wait.py", "Python", 0, 0, 0, -152, 0, -16, -61, -229
"c:\Users\edwar\OneDrive\Documents\Programming\Visual Studio 2022\PARTS_Web\app\bot_web\Lib\site-packages\pip\_vendor\tomli\__init__.py", "Python", 0, 0, 0, -4, 0, -4, -4, -12
"c:\Users\edwar\OneDrive\Documents\Programming\Visual Studio 2022\PARTS_Web\app\bot_web\Lib\site-packages\pip\_vendor\tomli\_parser.py", "Python", 0, 0, 0, -534, 0, -46, -112, -692
"c:\Users\edwar\OneDrive\Documents\Programming\Visual Studio 2022\PARTS_Web\app\bot_web\Lib\site-packages\pip\_vendor\tomli\_re.py", "Python", 0, 0, 0, -87, 0, -6, -15, -108
"c:\Users\edwar\OneDrive\Documents\Programming\Visual Studio 2022\PARTS_Web\app\bot_web\Lib\site-packages\pip\_vendor\tomli\_types.py", "Python", 0, 0, 0, -4, 0, -4, -3, -11
"c:\Users\edwar\OneDrive\Documents\Programming\Visual Studio 2022\PARTS_Web\app\bot_web\Lib\site-packages\pip\_vendor\truststore\__init__.py", "Python", 0, 0, 0, -8, 0, 0, -6, -14
"c:\Users\edwar\OneDrive\Documents\Programming\Visual Studio 2022\PARTS_Web\app\bot_web\Lib\site-packages\pip\_vendor\truststore\_api.py", "Python", 0, 0, 0, -231, 0, -15, -57, -303
"c:\Users\edwar\OneDrive\Documents\Programming\Visual Studio 2022\PARTS_Web\app\bot_web\Lib\site-packages\pip\_vendor\truststore\_macos.py", "Python", 0, 0, 0, -386, 0, -33, -83, -502
"c:\Users\edwar\OneDrive\Documents\Programming\Visual Studio 2022\PARTS_Web\app\bot_web\Lib\site-packages\pip\_vendor\truststore\_openssl.py", "Python", 0, 0, 0, -37, 0, -20, -10, -67
"c:\Users\edwar\OneDrive\Documents\Programming\Visual Studio 2022\PARTS_Web\app\bot_web\Lib\site-packages\pip\_vendor\truststore\_ssl_constants.py", "Python", 0, 0, 0, -17, 0, -7, -8, -32
"c:\Users\edwar\OneDrive\Documents\Programming\Visual Studio 2022\PARTS_Web\app\bot_web\Lib\site-packages\pip\_vendor\truststore\_windows.py", "Python", 0, 0, 0, -451, 0, -22, -82, -555
"c:\Users\edwar\OneDrive\Documents\Programming\Visual Studio 2022\PARTS_Web\app\bot_web\Lib\site-packages\pip\_vendor\typing_extensions.py", "Python", 0, 0, 0, -2304, 0, -194, -575, -3073
"c:\Users\edwar\OneDrive\Documents\Programming\Visual Studio 2022\PARTS_Web\app\bot_web\Lib\site-packages\pip\_vendor\urllib3\__init__.py", "Python", 0, 0, 0, -72, 0, -15, -16, -103
"c:\Users\edwar\OneDrive\Documents\Programming\Visual Studio 2022\PARTS_Web\app\bot_web\Lib\site-packages\pip\_vendor\urllib3\_collections.py", "Python", 0, 0, 0, -252, 0, -19, -67, -338
"c:\Users\edwar\OneDrive\Documents\Programming\Visual Studio 2022\PARTS_Web\app\bot_web\Lib\site-packages\pip\_vendor\urllib3\_version.py", "Python", 0, 0, 0, -1, 0, -1, -1, -3
"c:\Users\edwar\OneDrive\Documents\Programming\Visual Studio 2022\PARTS_Web\app\bot_web\Lib\site-packages\pip\_vendor\urllib3\connection.py", "Python", 0, 0, 0, -422, 0, -54, -97, -573
"c:\Users\edwar\OneDrive\Documents\Programming\Visual Studio 2022\PARTS_Web\app\bot_web\Lib\site-packages\pip\_vendor\urllib3\connectionpool.py", "Python", 0, 0, 0, -835, 0, -115, -183, -1133
"c:\Users\edwar\OneDrive\Documents\Programming\Visual Studio 2022\PARTS_Web\app\bot_web\Lib\site-packages\pip\_vendor\urllib3\contrib\__init__.py", "Python", 0, 0, 0, 0, 0, 0, -1, -1
"c:\Users\edwar\OneDrive\Documents\Programming\Visual Studio 2022\PARTS_Web\app\bot_web\Lib\site-packages\pip\_vendor\urllib3\contrib\_appengine_environ.py", "Python", 0, 0, 0, -24, 0, 0, -13, -37
"c:\Users\edwar\OneDrive\Documents\Programming\Visual Studio 2022\PARTS_Web\app\bot_web\Lib\site-packages\pip\_vendor\urllib3\contrib\_securetransport\__init__.py", "Python", 0, 0, 0, 0, 0, 0, -1, -1
"c:\Users\edwar\OneDrive\Documents\Programming\Visual Studio 2022\PARTS_Web\app\bot_web\Lib\site-packages\pip\_vendor\urllib3\contrib\_securetransport\bindings.py", "Python", 0, 0, 0, -414, 0, -9, -97, -520
"c:\Users\edwar\OneDrive\Documents\Programming\Visual Studio 2022\PARTS_Web\app\bot_web\Lib\site-packages\pip\_vendor\urllib3\contrib\_securetransport\low_level.py", "Python", 0, 0, 0, -285, 0, -51, -62, -398
"c:\Users\edwar\OneDrive\Documents\Programming\Visual Studio 2022\PARTS_Web\app\bot_web\Lib\site-packages\pip\_vendor\urllib3\contrib\appengine.py", "Python", 0, 0, 0, -244, 0, -14, -57, -315
"c:\Users\edwar\OneDrive\Documents\Programming\Visual Studio 2022\PARTS_Web\app\bot_web\Lib\site-packages\pip\_vendor\urllib3\contrib\ntlmpool.py", "Python", 0, 0, 0, -104, 0, -7, -20, -131
"c:\Users\edwar\OneDrive\Documents\Programming\Visual Studio 2022\PARTS_Web\app\bot_web\Lib\site-packages\pip\_vendor\urllib3\contrib\pyopenssl.py", "Python", 0, 0, 0, -389, 0, -25, -105, -519
"c:\Users\edwar\OneDrive\Documents\Programming\Visual Studio 2022\PARTS_Web\app\bot_web\Lib\site-packages\pip\_vendor\urllib3\contrib\securetransport.py", "Python", 0, 0, 0, -646, 0, -134, -142, -922
"c:\Users\edwar\OneDrive\Documents\Programming\Visual Studio 2022\PARTS_Web\app\bot_web\Lib\site-packages\pip\_vendor\urllib3\contrib\socks.py", "Python", 0, 0, 0, -167, 0, -7, -43, -217
"c:\Users\edwar\OneDrive\Documents\Programming\Visual Studio 2022\PARTS_Web\app\bot_web\Lib\site-packages\pip\_vendor\urllib3\exceptions.py", "Python", 0, 0, 0, -183, 0, -10, -131, -324
"c:\Users\edwar\OneDrive\Documents\Programming\Visual Studio 2022\PARTS_Web\app\bot_web\Lib\site-packages\pip\_vendor\urllib3\fields.py", "Python", 0, 0, 0, -212, 0, -5, -58, -275
"c:\Users\edwar\OneDrive\Documents\Programming\Visual Studio 2022\PARTS_Web\app\bot_web\Lib\site-packages\pip\_vendor\urllib3\filepost.py", "Python", 0, 0, 0, -70, 0, 0, -29, -99
"c:\Users\edwar\OneDrive\Documents\Programming\Visual Studio 2022\PARTS_Web\app\bot_web\Lib\site-packages\pip\_vendor\urllib3\packages\__init__.py", "Python", 0, 0, 0, 0, 0, 0, -1, -1
"c:\Users\edwar\OneDrive\Documents\Programming\Visual Studio 2022\PARTS_Web\app\bot_web\Lib\site-packages\pip\_vendor\urllib3\packages\backports\__init__.py", "Python", 0, 0, 0, 0, 0, 0, -1, -1
"c:\Users\edwar\OneDrive\Documents\Programming\Visual Studio 2022\PARTS_Web\app\bot_web\Lib\site-packages\pip\_vendor\urllib3\packages\backports\makefile.py", "Python", 0, 0, 0, -47, 0, -1, -4, -52
"c:\Users\edwar\OneDrive\Documents\Programming\Visual Studio 2022\PARTS_Web\app\bot_web\Lib\site-packages\pip\_vendor\urllib3\packages\backports\weakref_finalize.py", "Python", 0, 0, 0, -120, 0, -15, -21, -156
"c:\Users\edwar\OneDrive\Documents\Programming\Visual Studio 2022\PARTS_Web\app\bot_web\Lib\site-packages\pip\_vendor\urllib3\packages\six.py", "Python", 0, 0, 0, -805, 0, -53, -219, -1077
"c:\Users\edwar\OneDrive\Documents\Programming\Visual Studio 2022\PARTS_Web\app\bot_web\Lib\site-packages\pip\_vendor\urllib3\poolmanager.py", "Python", 0, 0, 0, -402, 0, -33, -103, -538
"c:\Users\edwar\OneDrive\Documents\Programming\Visual Studio 2022\PARTS_Web\app\bot_web\Lib\site-packages\pip\_vendor\urllib3\request.py", "Python", 0, 0, 0, -151, 0, 0, -41, -192
"c:\Users\edwar\OneDrive\Documents\Programming\Visual Studio 2022\PARTS_Web\app\bot_web\Lib\site-packages\pip\_vendor\urllib3\response.py", "Python", 0, 0, 0, -669, 0, -79, -132, -880
"c:\Users\edwar\OneDrive\Documents\Programming\Visual Studio 2022\PARTS_Web\app\bot_web\Lib\site-packages\pip\_vendor\urllib3\util\__init__.py", "Python", 0, 0, 0, -46, 0, -1, -3, -50
"c:\Users\edwar\OneDrive\Documents\Programming\Visual Studio 2022\PARTS_Web\app\bot_web\Lib\site-packages\pip\_vendor\urllib3\util\connection.py", "Python", 0, 0, 0, -100, 0, -18, -32, -150
"c:\Users\edwar\OneDrive\Documents\Programming\Visual Studio 2022\PARTS_Web\app\bot_web\Lib\site-packages\pip\_vendor\urllib3\util\proxy.py", "Python", 0, 0, 0, -43, 0, -4, -11, -58
"c:\Users\edwar\OneDrive\Documents\Programming\Visual Studio 2022\PARTS_Web\app\bot_web\Lib\site-packages\pip\_vendor\urllib3\util\queue.py", "Python", 0, 0, 0, -14, 0, -1, -8, -23
"c:\Users\edwar\OneDrive\Documents\Programming\Visual Studio 2022\PARTS_Web\app\bot_web\Lib\site-packages\pip\_vendor\urllib3\util\request.py", "Python", 0, 0, 0, -103, 0, -6, -29, -138
"c:\Users\edwar\OneDrive\Documents\Programming\Visual Studio 2022\PARTS_Web\app\bot_web\Lib\site-packages\pip\_vendor\urllib3\util\response.py", "Python", 0, 0, 0, -64, 0, -20, -24, -108
"c:\Users\edwar\OneDrive\Documents\Programming\Visual Studio 2022\PARTS_Web\app\bot_web\Lib\site-packages\pip\_vendor\urllib3\util\retry.py", "Python", 0, 0, 0, -469, 0, -29, -123, -621
"c:\Users\edwar\OneDrive\Documents\Programming\Visual Studio 2022\PARTS_Web\app\bot_web\Lib\site-packages\pip\_vendor\urllib3\util\ssl_.py", "Python", 0, 0, 0, -352, 0, -59, -85, -496
"c:\Users\edwar\OneDrive\Documents\Programming\Visual Studio 2022\PARTS_Web\app\bot_web\Lib\site-packages\pip\_vendor\urllib3\util\ssl_match_hostname.py", "Python", 0, 0, 0, -99, 0, -37, -24, -160
"c:\Users\edwar\OneDrive\Documents\Programming\Visual Studio 2022\PARTS_Web\app\bot_web\Lib\site-packages\pip\_vendor\urllib3\util\ssltransport.py", "Python", 0, 0, 0, -178, 0, -2, -42, -222
"c:\Users\edwar\OneDrive\Documents\Programming\Visual Studio 2022\PARTS_Web\app\bot_web\Lib\site-packages\pip\_vendor\urllib3\util\timeout.py", "Python", 0, 0, 0, -200, 0, -11, -61, -272
"c:\Users\edwar\OneDrive\Documents\Programming\Visual Studio 2022\PARTS_Web\app\bot_web\Lib\site-packages\pip\_vendor\urllib3\util\url.py", "Python", 0, 0, 0, -320, 0, -37, -79, -436
"c:\Users\edwar\OneDrive\Documents\Programming\Visual Studio 2022\PARTS_Web\app\bot_web\Lib\site-packages\pip\_vendor\urllib3\util\wait.py", "Python", 0, 0, 0, -89, 0, -38, -26, -153
"c:\Users\edwar\OneDrive\Documents\Programming\Visual Studio 2022\PARTS_Web\app\bot_web\Lib\site-packages\pip\_vendor\webencodings\__init__.py", "Python", 0, 0, 0, -249, 0, -14, -80, -343
"c:\Users\edwar\OneDrive\Documents\Programming\Visual Studio 2022\PARTS_Web\app\bot_web\Lib\site-packages\pip\_vendor\webencodings\labels.py", "Python", 0, 0, 0, -223, 0, -2, -7, -232
"c:\Users\edwar\OneDrive\Documents\Programming\Visual Studio 2022\PARTS_Web\app\bot_web\Lib\site-packages\pip\_vendor\webencodings\mklabels.py", "Python", 0, 0, 0, -40, 0, -2, -18, -60
"c:\Users\edwar\OneDrive\Documents\Programming\Visual Studio 2022\PARTS_Web\app\bot_web\Lib\site-packages\pip\_vendor\webencodings\tests.py", "Python", 0, 0, 0, -123, 0, -2, -29, -154
"c:\Users\edwar\OneDrive\Documents\Programming\Visual Studio 2022\PARTS_Web\app\bot_web\Lib\site-packages\pip\_vendor\webencodings\x_user_defined.py", "Python", 0, 0, 0, -292, 0, -7, -27, -326
"c:\Users\edwar\OneDrive\Documents\Programming\Visual Studio 2022\PARTS_Web\app\bot_web\Scripts\Activate.ps1", "PowerShell", 0, 0, -108, 0, 0, -360, -35, -503
"c:\Users\edwar\OneDrive\Documents\Programming\Visual Studio 2022\PARTS_Web\app\bot_web\Scripts\activate.bat", "Batch", 0, -24, 0, 0, 0, -1, -10, -35
"c:\Users\edwar\OneDrive\Documents\Programming\Visual Studio 2022\PARTS_Web\app\bot_web\Scripts\deactivate.bat", "Batch", 0, -16, 0, 0, 0, 0, -7, -23
"c:\Users\edwar\OneDrive\Documents\Programming\Visual Studio 2022\PARTS_Web\app\bot_web\pyvenv.cfg", "Properties", -5, 0, 0, 0, 0, 0, -1, -6
"c:\Users\edwar\OneDrive\Documents\Programming\Visual Studio 2022\PARTS_Web\app\env_test\Lib\site-packages\_distutils_hack\__init__.py", "Python", 0, 0, 0, -93, 0, -3, -33, -129
"c:\Users\edwar\OneDrive\Documents\Programming\Visual Studio 2022\PARTS_Web\app\env_test\Lib\site-packages\_distutils_hack\override.py", "Python", 0, 0, 0, -1, 0, 0, -1, -2
"c:\Users\edwar\OneDrive\Documents\Programming\Visual Studio 2022\PARTS_Web\app\env_test\Lib\site-packages\pip\__init__.py", "Python", 0, 0, 0, -8, 0, 0, -6, -14
"c:\Users\edwar\OneDrive\Documents\Programming\Visual Studio 2022\PARTS_Web\app\env_test\Lib\site-packages\pip\__main__.py", "Python", 0, 0, 0, -14, 0, -13, -5, -32
"c:\Users\edwar\OneDrive\Documents\Programming\Visual Studio 2022\PARTS_Web\app\env_test\Lib\site-packages\pip\__pip-runner__.py", "Python", 0, 0, 0, -29, 0, -4, -18, -51
"c:\Users\edwar\OneDrive\Documents\Programming\Visual Studio 2022\PARTS_Web\app\env_test\Lib\site-packages\pip\_internal\__init__.py", "Python", 0, 0, 0, -11, 0, -2, -7, -20
"c:\Users\edwar\OneDrive\Documents\Programming\Visual Studio 2022\PARTS_Web\app\env_test\Lib\site-packages\pip\_internal\build_env.py", "Python", 0, 0, 0, -252, 0, -15, -45, -312
"c:\Users\edwar\OneDrive\Documents\Programming\Visual Studio 2022\PARTS_Web\app\env_test\Lib\site-packages\pip\_internal\cache.py", "Python", 0, 0, 0, -221, 0, -19, -54, -294
"c:\Users\edwar\OneDrive\Documents\Programming\Visual Studio 2022\PARTS_Web\app\env_test\Lib\site-packages\pip\_internal\cli\__init__.py", "Python", 0, 0, 0, -2, 0, -1, -2, -5
"c:\Users\edwar\OneDrive\Documents\Programming\Visual Studio 2022\PARTS_Web\app\env_test\Lib\site-packages\pip\_internal\cli\autocompletion.py", "Python", 0, 0, 0, -134, 0, -19, -19, -172
"c:\Users\edwar\OneDrive\Documents\Programming\Visual Studio 2022\PARTS_Web\app\env_test\Lib\site-packages\pip\_internal\cli\base_command.py", "Python", 0, 0, 0, -162, 0, -17, -38, -217
"c:\Users\edwar\OneDrive\Documents\Programming\Visual Studio 2022\PARTS_Web\app\env_test\Lib\site-packages\pip\_internal\cli\cmdoptions.py", "Python", 0, 0, 0, -866, 0, -37, -153, -1056
"c:\Users\edwar\OneDrive\Documents\Programming\Visual Studio 2022\PARTS_Web\app\env_test\Lib\site-packages\pip\_internal\cli\command_context.py", "Python", 0, 0, 0, -20, 0, 0, -8, -28
"c:\Users\edwar\OneDrive\Documents\Programming\Visual Studio 2022\PARTS_Web\app\env_test\Lib\site-packages\pip\_internal\cli\main.py", "Python", 0, 0, 0, -30, 0, -26, -15, -71
"c:\Users\edwar\OneDrive\Documents\Programming\Visual Studio 2022\PARTS_Web\app\env_test\Lib\site-packages\pip\_internal\cli\main_parser.py", "Python", 0, 0, 0, -82, 0, -24, -29, -135
"c:\Users\edwar\OneDrive\Documents\Programming\Visual Studio 2022\PARTS_Web\app\env_test\Lib\site-packages\pip\_internal\cli\parser.py", "Python", 0, 0, 0, -222, 0, -20, -53, -295
"c:\Users\edwar\OneDrive\Documents\Programming\Visual Studio 2022\PARTS_Web\app\env_test\Lib\site-packages\pip\_internal\cli\progress_bars.py", "Python", 0, 0, 0, -58, 0, 0, -11, -69
"c:\Users\edwar\OneDrive\Documents\Programming\Visual Studio 2022\PARTS_Web\app\env_test\Lib\site-packages\pip\_internal\cli\req_command.py", "Python", 0, 0, 0, -405, 0, -29, -69, -503
"c:\Users\edwar\OneDrive\Documents\Programming\Visual Studio 2022\PARTS_Web\app\env_test\Lib\site-packages\pip\_internal\cli\spinners.py", "Python", 0, 0, 0, -114, 0, -18, -28, -160
"c:\Users\edwar\OneDrive\Documents\Programming\Visual Studio 2022\PARTS_Web\app\env_test\Lib\site-packages\pip\_internal\cli\status_codes.py", "Python", 0, 0, 0, -6, 0, 0, -1, -7
"c:\Users\edwar\OneDrive\Documents\Programming\Visual Studio 2022\PARTS_Web\app\env_test\Lib\site-packages\pip\_internal\commands\__init__.py", "Python", 0, 0, 0, -113, 0, -7, -13, -133
"c:\Users\edwar\OneDrive\Documents\Programming\Visual Studio 2022\PARTS_Web\app\env_test\Lib\site-packages\pip\_internal\commands\cache.py", "Python", 0, 0, 0, -158, 0, -20, -46, -224
"c:\Users\edwar\OneDrive\Documents\Programming\Visual Studio 2022\PARTS_Web\app\env_test\Lib\site-packages\pip\_internal\commands\check.py", "Python", 0, 0, 0, -43, 0, 0, -11, -54
"c:\Users\edwar\OneDrive\Documents\Programming\Visual Studio 2022\PARTS_Web\app\env_test\Lib\site-packages\pip\_internal\commands\completion.py", "Python", 0, 0, 0, -115, 0, -2, -10, -127
"c:\Users\edwar\OneDrive\Documents\Programming\Visual Studio 2022\PARTS_Web\app\env_test\Lib\site-packages\pip\_internal\commands\configuration.py", "Python", 0, 0, 0, -226, 0, -12, -45, -283
"c:\Users\edwar\OneDrive\Documents\Programming\Visual Studio 2022\PARTS_Web\app\env_test\Lib\site-packages\pip\_internal\commands\debug.py", "Python", 0, 0, 0, -148, 0, -7, -45, -200
"c:\Users\edwar\OneDrive\Documents\Programming\Visual Studio 2022\PARTS_Web\app\env_test\Lib\site-packages\pip\_internal\commands\download.py", "Python", 0, 0, 0, -120, 0, -2, -28, -150
"c:\Users\edwar\OneDrive\Documents\Programming\Visual Studio 2022\PARTS_Web\app\env_test\Lib\site-packages\pip\_internal\commands\freeze.py", "Python", 0, 0, 0, -85, 0, 0, -13, -98
"c:\Users\edwar\OneDrive\Documents\Programming\Visual Studio 2022\PARTS_Web\app\env_test\Lib\site-packages\pip\_internal\commands\hash.py", "Python", 0, 0, 0, -48, 0, 0, -12, -60
"c:\Users\edwar\OneDrive\Documents\Programming\Visual Studio 2022\PARTS_Web\app\env_test\Lib\site-packages\pip\_internal\commands\help.py", "Python", 0, 0, 0, -29, 0, -1, -12, -42
"c:\Users\edwar\OneDrive\Documents\Programming\Visual Studio 2022\PARTS_Web\app\env_test\Lib\site-packages\pip\_internal\commands\index.py", "Python", 0, 0, 0, -108, 0, -4, -28, -140
"c:\Users\edwar\OneDrive\Documents\Programming\Visual Studio 2022\PARTS_Web\app\env_test\Lib\site-packages\pip\_internal\commands\inspect.py", "Python", 0, 0, 0, -77, 0, -6, -10, -93
"c:\Users\edwar\OneDrive\Documents\Programming\Visual Studio 2022\PARTS_Web\app\env_test\Lib\site-packages\pip\_internal\commands\install.py", "Python", 0, 0, 0, -725, 0, -41, -108, -874
"c:\Users\edwar\OneDrive\Documents\Programming\Visual Studio 2022\PARTS_Web\app\env_test\Lib\site-packages\pip\_internal\commands\list.py", "Python", 0, 0, 0, -296, 0, -13, -57, -366
"c:\Users\edwar\OneDrive\Documents\Programming\Visual Studio 2022\PARTS_Web\app\env_test\Lib\site-packages\pip\_internal\commands\search.py", "Python", 0, 0, 0, -142, 0, -2, -31, -175
"c:\Users\edwar\OneDrive\Documents\Programming\Visual Studio 2022\PARTS_Web\app\env_test\Lib\site-packages\pip\_internal\commands\show.py", "Python", 0, 0, 0, -162, 0, 0, -28, -190
"c:\Users\edwar\OneDrive\Documents\Programming\Visual Studio 2022\PARTS_Web\app\env_test\Lib\site-packages\pip\_internal\commands\uninstall.py", "Python", 0, 0, 0, -99, 0, 0, -15, -114
"c:\Users\edwar\OneDrive\Documents\Programming\Visual Studio 2022\PARTS_Web\app\env_test\Lib\site-packages\pip\_internal\commands\wheel.py", "Python", 0, 0, 0, -169, 0, -4, -31, -204
"c:\Users\edwar\OneDrive\Documents\Programming\Visual Studio 2022\PARTS_Web\app\env_test\Lib\site-packages\pip\_internal\configuration.py", "Python", 0, 0, 0, -269, 0, -34, -72, -375
"c:\Users\edwar\OneDrive\Documents\Programming\Visual Studio 2022\PARTS_Web\app\env_test\Lib\site-packages\pip\_internal\distributions\__init__.py", "Python", 0, 0, 0, -13, 0, -4, -5, -22
"c:\Users\edwar\OneDrive\Documents\Programming\Visual Studio 2022\PARTS_Web\app\env_test\Lib\site-packages\pip\_internal\distributions\base.py", "Python", 0, 0, 0, -29, 0, 0, -11, -40
"c:\Users\edwar\OneDrive\Documents\Programming\Visual Studio 2022\PARTS_Web\app\env_test\Lib\site-packages\pip\_internal\distributions\installed.py", "Python", 0, 0, 0, -18, 0, 0, -6, -24
"c:\Users\edwar\OneDrive\Documents\Programming\Visual Studio 2022\PARTS_Web\app\env_test\Lib\site-packages\pip\_internal\distributions\sdist.py", "Python", 0, 0, 0, -117, 0, -18, -16, -151
"c:\Users\edwar\OneDrive\Documents\Programming\Visual Studio 2022\PARTS_Web\app\env_test\Lib\site-packages\pip\_internal\distributions\wheel.py", "Python", 0, 0, 0, -28, 0, 0, -7, -35
"c:\Users\edwar\OneDrive\Documents\Programming\Visual Studio 2022\PARTS_Web\app\env_test\Lib\site-packages\pip\_internal\exceptions.py", "Python", 0, 0, 0, -561, 0, -23, -164, -748
"c:\Users\edwar\OneDrive\Documents\Programming\Visual Studio 2022\PARTS_Web\app\env_test\Lib\site-packages\pip\_internal\index\__init__.py", "Python", 0, 0, 0, -2, 0, 0, -1, -3
"c:\Users\edwar\OneDrive\Documents\Programming\Visual Studio 2022\PARTS_Web\app\env_test\Lib\site-packages\pip\_internal\index\collector.py", "Python", 0, 0, 0, -391, 0, -29, -86, -506
"c:\Users\edwar\OneDrive\Documents\Programming\Visual Studio 2022\PARTS_Web\app\env_test\Lib\site-packages\pip\_internal\index\package_finder.py", "Python", 0, 0, 0, -844, 0, -39, -147, -1030
"c:\Users\edwar\OneDrive\Documents\Programming\Visual Studio 2022\PARTS_Web\app\env_test\Lib\site-packages\pip\_internal\index\sources.py", "Python", 0, 0, 0, -178, 0, 0, -47, -225
"c:\Users\edwar\OneDrive\Documents\Programming\Visual Studio 2022\PARTS_Web\app\env_test\Lib\site-packages\pip\_internal\locations\__init__.py", "Python", 0, 0, 0, -345, 0, -37, -86, -468
"c:\Users\edwar\OneDrive\Documents\Programming\Visual Studio 2022\PARTS_Web\app\env_test\Lib\site-packages\pip\_internal\locations\_distutils.py", "Python", 0, 0, 0, -127, 0, -22, -25, -174
"c:\Users\edwar\OneDrive\Documents\Programming\Visual Studio 2022\PARTS_Web\app\env_test\Lib\site-packages\pip\_internal\locations\_sysconfig.py", "Python", 0, 0, 0, -158, 0, -17, -39, -214
"c:\Users\edwar\OneDrive\Documents\Programming\Visual Studio 2022\PARTS_Web\app\env_test\Lib\site-packages\pip\_internal\locations\base.py", "Python", 0, 0, 0, -55, 0, -8, -19, -82
"c:\Users\edwar\OneDrive\Documents\Programming\Visual Studio 2022\PARTS_Web\app\env_test\Lib\site-packages\pip\_internal\main.py", "Python", 0, 0, 0, -8, 0, 0, -5, -13
"c:\Users\edwar\OneDrive\Documents\Programming\Visual Studio 2022\PARTS_Web\app\env_test\Lib\site-packages\pip\_internal\metadata\__init__.py", "Python", 0, 0, 0, -95, 0, 0, -33, -128
"c:\Users\edwar\OneDrive\Documents\Programming\Visual Studio 2022\PARTS_Web\app\env_test\Lib\site-packages\pip\_internal\metadata\_json.py", "Python", 0, 0, 0, -68, 0, -6, -11, -85
"c:\Users\edwar\OneDrive\Documents\Programming\Visual Studio 2022\PARTS_Web\app\env_test\Lib\site-packages\pip\_internal\metadata\base.py", "Python", 0, 0, 0, -553, 0, -15, -121, -689
"c:\Users\edwar\OneDrive\Documents\Programming\Visual Studio 2022\PARTS_Web\app\env_test\Lib\site-packages\pip\_internal\metadata\importlib\__init__.py", "Python", 0, 0, 0, -3, 0, 0, -2, -5
"c:\Users\edwar\OneDrive\Documents\Programming\Visual Studio 2022\PARTS_Web\app\env_test\Lib\site-packages\pip\_internal\metadata\importlib\_compat.py", "Python", 0, 0, 0, -40, 0, 0, -16, -56
"c:\Users\edwar\OneDrive\Documents\Programming\Visual Studio 2022\PARTS_Web\app\env_test\Lib\site-packages\pip\_internal\metadata\importlib\_dists.py", "Python", 0, 0, 0, -182, 0, -12, -31, -225
"c:\Users\edwar\OneDrive\Documents\Programming\Visual Studio 2022\PARTS_Web\app\env_test\Lib\site-packages\pip\_internal\metadata\importlib\_envs.py", "Python", 0, 0, 0, -148, 0, -7, -34, -189
"c:\Users\edwar\OneDrive\Documents\Programming\Visual Studio 2022\PARTS_Web\app\env_test\Lib\site-packages\pip\_internal\metadata\pkg_resources.py", "Python", 0, 0, 0, -207, 0, -17, -47, -271
"c:\Users\edwar\OneDrive\Documents\Programming\Visual Studio 2022\PARTS_Web\app\env_test\Lib\site-packages\pip\_internal\models\__init__.py", "Python", 0, 0, 0, -2, 0, 0, -1, -3
"c:\Users\edwar\OneDrive\Documents\Programming\Visual Studio 2022\PARTS_Web\app\env_test\Lib\site-packages\pip\_internal\models\candidate.py", "Python", 0, 0, 0, -26, 0, 0, -9, -35
"c:\Users\edwar\OneDrive\Documents\Programming\Visual Studio 2022\PARTS_Web\app\env_test\Lib\site-packages\pip\_internal\models\direct_url.py", "Python", 0, 0, 0, -186, 0, -2, -41, -229
"c:\Users\edwar\OneDrive\Documents\Programming\Visual Studio 2022\PARTS_Web\app\env_test\Lib\site-packages\pip\_internal\models\format_control.py", "Python", 0, 0, 0, -65, 0, -1, -15, -81
"c:\Users\edwar\OneDrive\Documents\Programming\Visual Studio 2022\PARTS_Web\app\env_test\Lib\site-packages\pip\_internal\models\index.py", "Python", 0, 0, 0, -17, 0, -3, -9, -29
"c:\Users\edwar\OneDrive\Documents\Programming\Visual Studio 2022\PARTS_Web\app\env_test\Lib\site-packages\pip\_internal\models\installation_report.py", "Python", 0, 0, 0, -28, 0, -19, -7, -54
"c:\Users\edwar\OneDrive\Documents\Programming\Visual Studio 2022\PARTS_Web\app\env_test\Lib\site-packages\pip\_internal\models\link.py", "Python", 0, 0, 0, -396, 0, -40, -89, -525
"c:\Users\edwar\OneDrive\Documents\Programming\Visual Studio 2022\PARTS_Web\app\env_test\Lib\site-packages\pip\_internal\models\scheme.py", "Python", 0, 0, 0, -24, 0, 0, -8, -32
"c:\Users\edwar\OneDrive\Documents\Programming\Visual Studio 2022\PARTS_Web\app\env_test\Lib\site-packages\pip\_internal\models\search_scope.py", "Python", 0, 0, 0, -93, 0, -18, -23, -134
"c:\Users\edwar\OneDrive\Documents\Programming\Visual Studio 2022\PARTS_Web\app\env_test\Lib\site-packages\pip\_internal\models\selection_prefs.py", "Python", 0, 0, 0, -40, 0, -4, -8, -52
"c:\Users\edwar\OneDrive\Documents\Programming\Visual Studio 2022\PARTS_Web\app\env_test\Lib\site-packages\pip\_internal\models\target_python.py", "Python", 0, 0, 0, -89, 0, -4, -18, -111
"c:\Users\edwar\OneDrive\Documents\Programming\Visual Studio 2022\PARTS_Web\app\env_test\Lib\site-packages\pip\_internal\models\wheel.py", "Python", 0, 0, 0, -71, 0, -3, -19, -93
"c:\Users\edwar\OneDrive\Documents\Programming\Visual Studio 2022\PARTS_Web\app\env_test\Lib\site-packages\pip\_internal\network\__init__.py", "Python", 0, 0, 0, -2, 0, 0, -1, -3
"c:\Users\edwar\OneDrive\Documents\Programming\Visual Studio 2022\PARTS_Web\app\env_test\Lib\site-packages\pip\_internal\network\auth.py", "Python", 0, 0, 0, -301, 0, -60, -86, -447
"c:\Users\edwar\OneDrive\Documents\Programming\Visual Studio 2022\PARTS_Web\app\env_test\Lib\site-packages\pip\_internal\network\cache.py", "Python", 0, 0, 0, -50, 0, -3, -17, -70
"c:\Users\edwar\OneDrive\Documents\Programming\Visual Studio 2022\PARTS_Web\app\env_test\Lib\site-packages\pip\_internal\network\download.py", "Python", 0, 0, 0, -150, 0, -3, -34, -187
"c:\Users\edwar\OneDrive\Documents\Programming\Visual Studio 2022\PARTS_Web\app\env_test\Lib\site-packages\pip\_internal\network\lazy_wheel.py", "Python", 0, 0, 0, -166, 0, -7, -38, -211
"c:\Users\edwar\OneDrive\Documents\Programming\Visual Studio 2022\PARTS_Web\app\env_test\Lib\site-packages\pip\_internal\network\session.py", "Python", 0, 0, 0, -357, 0, -80, -82, -519
"c:\Users\edwar\OneDrive\Documents\Programming\Visual Studio 2022\PARTS_Web\app\env_test\Lib\site-packages\pip\_internal\network\utils.py", "Python", 0, 0, 0, -39, 0, -47, -11, -97
"c:\Users\edwar\OneDrive\Documents\Programming\Visual Studio 2022\PARTS_Web\app\env_test\Lib\site-packages\pip\_internal\network\xmlrpc.py", "Python", 0, 0, 0, -52, 0, 0, -9, -61
"c:\Users\edwar\OneDrive\Documents\Programming\Visual Studio 2022\PARTS_Web\app\env_test\Lib\site-packages\pip\_internal\operations\__init__.py", "Python", 0, 0, 0, 0, 0, 0, -1, -1
"c:\Users\edwar\OneDrive\Documents\Programming\Visual Studio 2022\PARTS_Web\app\env_test\Lib\site-packages\pip\_internal\operations\check.py", "Python", 0, 0, 0, -103, 0, -10, -37, -150
"c:\Users\edwar\OneDrive\Documents\Programming\Visual Studio 2022\PARTS_Web\app\env_test\Lib\site-packages\pip\_internal\operations\freeze.py", "Python", 0, 0, 0, -213, 0, -12, -30, -255
"c:\Users\edwar\OneDrive\Documents\Programming\Visual Studio 2022\PARTS_Web\app\env_test\Lib\site-packages\pip\_internal\operations\install\__init__.py", "Python", 0, 0, 0, -2, 0, 0, -1, -3
"c:\Users\edwar\OneDrive\Documents\Programming\Visual Studio 2022\PARTS_Web\app\env_test\Lib\site-packages\pip\_internal\operations\install\editable_legacy.py", "Python", 0, 0, 0, -41, 0, 0, -7, -48
"c:\Users\edwar\OneDrive\Documents\Programming\Visual Studio 2022\PARTS_Web\app\env_test\Lib\site-packages\pip\_internal\operations\install\legacy.py", "Python", 0, 0, 0, -97, 0, -6, -18, -121
"c:\Users\edwar\OneDrive\Documents\Programming\Visual Studio 2022\PARTS_Web\app\env_test\Lib\site-packages\pip\_internal\operations\install\wheel.py", "Python", 0, 0, 0, -527, 0, -94, -118, -739
"c:\Users\edwar\OneDrive\Documents\Programming\Visual Studio 2022\PARTS_Web\app\env_test\Lib\site-packages\pip\_internal\operations\prepare.py", "Python", 0, 0, 0, -490, 0, -93, -85, -668
"c:\Users\edwar\OneDrive\Documents\Programming\Visual Studio 2022\PARTS_Web\app\env_test\Lib\site-packages\pip\_internal\pyproject.py", "Python", 0, 0, 0, -102, 0, -44, -29, -175
"c:\Users\edwar\OneDrive\Documents\Programming\Visual Studio 2022\PARTS_Web\app\env_test\Lib\site-packages\pip\_internal\req\__init__.py", "Python", 0, 0, 0, -75, 0, -1, -19, -95
"c:\Users\edwar\OneDrive\Documents\Programming\Visual Studio 2022\PARTS_Web\app\env_test\Lib\site-packages\pip\_internal\req\constructors.py", "Python", 0, 0, 0, -406, 0, -22, -74, -502
"c:\Users\edwar\OneDrive\Documents\Programming\Visual Studio 2022\PARTS_Web\app\env_test\Lib\site-packages\pip\_internal\req\req_file.py", "Python", 0, 0, 0, -416, 0, -36, -93, -545
"c:\Users\edwar\OneDrive\Documents\Programming\Visual Studio 2022\PARTS_Web\app\env_test\Lib\site-packages\pip\_internal\req\req_install.py", "Python", 0, 0, 0, -762, 0, -72, -113, -947
"c:\Users\edwar\OneDrive\Documents\Programming\Visual Studio 2022\PARTS_Web\app\env_test\Lib\site-packages\pip\_internal\req\req_set.py", "Python", 0, 0, 0, -61, 0, 0, -22, -83
"c:\Users\edwar\OneDrive\Documents\Programming\Visual Studio 2022\PARTS_Web\app\env_test\Lib\site-packages\pip\_internal\req\req_uninstall.py", "Python", 0, 0, 0, -483, 0, -54, -104, -641
"c:\Users\edwar\OneDrive\Documents\Programming\Visual Studio 2022\PARTS_Web\app\env_test\Lib\site-packages\pip\_internal\resolution\__init__.py", "Python", 0, 0, 0, 0, 0, 0, -1, -1
"c:\Users\edwar\OneDrive\Documents\Programming\Visual Studio 2022\PARTS_Web\app\env_test\Lib\site-packages\pip\_internal\resolution\base.py", "Python", 0, 0, 0, -15, 0, 0, -6, -21
"c:\Users\edwar\OneDrive\Documents\Programming\Visual Studio 2022\PARTS_Web\app\env_test\Lib\site-packages\pip\_internal\resolution\legacy\__init__.py", "Python", 0, 0, 0, 0, 0, 0, -1, -1
"c:\Users\edwar\OneDrive\Documents\Programming\Visual Studio 2022\PARTS_Web\app\env_test\Lib\site-packages\pip\_internal\resolution\legacy\resolver.py", "Python", 0, 0, 0, -450, 0, -70, -81, -601
"c:\Users\edwar\OneDrive\Documents\Programming\Visual Studio 2022\PARTS_Web\app\env_test\Lib\site-packages\pip\_internal\resolution\resolvelib\__init__.py", "Python", 0, 0, 0, 0, 0, 0, -1, -1
"c:\Users\edwar\OneDrive\Documents\Programming\Visual Studio 2022\PARTS_Web\app\env_test\Lib\site-packages\pip\_internal\resolution\resolvelib\base.py", "Python", 0, 0, 0, -103, 0, -4, -35, -142
"c:\Users\edwar\OneDrive\Documents\Programming\Visual Studio 2022\PARTS_Web\app\env_test\Lib\site-packages\pip\_internal\resolution\resolvelib\candidates.py", "Python", 0, 0, 0, -439, 0, -22, -96, -557
"c:\Users\edwar\OneDrive\Documents\Programming\Visual Studio 2022\PARTS_Web\app\env_test\Lib\site-packages\pip\_internal\resolution\resolvelib\factory.py", "Python", 0, 0, 0, -592, 0, -61, -79, -732
"c:\Users\edwar\OneDrive\Documents\Programming\Visual Studio 2022\PARTS_Web\app\env_test\Lib\site-packages\pip\_internal\resolution\resolvelib\found_candidates.py", "Python", 0, 0, 0, -112, 0, -18, -26, -156
"c:\Users\edwar\OneDrive\Documents\Programming\Visual Studio 2022\PARTS_Web\app\env_test\Lib\site-packages\pip\_internal\resolution\resolvelib\provider.py", "Python", 0, 0, 0, -179, 0, -35, -35, -249
"c:\Users\edwar\OneDrive\Documents\Programming\Visual Studio 2022\PARTS_Web\app\env_test\Lib\site-packages\pip\_internal\resolution\resolvelib\reporter.py", "Python", 0, 0, 0, -50, 0, 0, -19, -69
"c:\Users\edwar\OneDrive\Documents\Programming\Visual Studio 2022\PARTS_Web\app\env_test\Lib\site-packages\pip\_internal\resolution\resolvelib\requirements.py", "Python", 0, 0, 0, -112, 0, -12, -43, -167
"c:\Users\edwar\OneDrive\Documents\Programming\Visual Studio 2022\PARTS_Web\app\env_test\Lib\site-packages\pip\_internal\resolution\resolvelib\resolver.py", "Python", 0, 0, 0, -222, 0, -29, -46, -297
"c:\Users\edwar\OneDrive\Documents\Programming\Visual Studio 2022\PARTS_Web\app\env_test\Lib\site-packages\pip\_internal\self_outdated_check.py", "Python", 0, 0, 0, -180, 0, -16, -47, -243
"c:\Users\edwar\OneDrive\Documents\Programming\Visual Studio 2022\PARTS_Web\app\env_test\Lib\site-packages\pip\_internal\utils\__init__.py", "Python", 0, 0, 0, 0, 0, 0, -1, -1
"c:\Users\edwar\OneDrive\Documents\Programming\Visual Studio 2022\PARTS_Web\app\env_test\Lib\site-packages\pip\_internal\utils\_log.py", "Python", 0, 0, 0, -23, 0, -2, -14, -39
"c:\Users\edwar\OneDrive\Documents\Programming\Visual Studio 2022\PARTS_Web\app\env_test\Lib\site-packages\pip\_internal\utils\appdirs.py", "Python", 0, 0, 0, -31, 0, -5, -17, -53
"c:\Users\edwar\OneDrive\Documents\Programming\Visual Studio 2022\PARTS_Web\app\env_test\Lib\site-packages\pip\_internal\utils\compat.py", "Python", 0, 0, 0, -36, 0, -9, -19, -64
"c:\Users\edwar\OneDrive\Documents\Programming\Visual Studio 2022\PARTS_Web\app\env_test\Lib\site-packages\pip\_internal\utils\compatibility_tags.py", "Python", 0, 0, 0, -121, 0, -16, -29, -166
"c:\Users\edwar\OneDrive\Documents\Programming\Visual Studio 2022\PARTS_Web\app\env_test\Lib\site-packages\pip\_internal\utils\datetime.py", "Python", 0, 0, 0, -7, 0, 0, -5, -12
"c:\Users\edwar\OneDrive\Documents\Programming\Visual Studio 2022\PARTS_Web\app\env_test\Lib\site-packages\pip\_internal\utils\deprecation.py", "Python", 0, 0, 0, -152, 0, -6, -31, -189
"c:\Users\edwar\OneDrive\Documents\Programming\Visual Studio 2022\PARTS_Web\app\env_test\Lib\site-packages\pip\_internal\utils\direct_url_helpers.py", "Python", 0, 0, 0, -71, 0, -9, -8, -88
"c:\Users\edwar\OneDrive\Documents\Programming\Visual Studio 2022\PARTS_Web\app\env_test\Lib\site-packages\pip\_internal\utils\distutils_args.py", "Python", 0, 0, 0, -33, 0, -3, -8, -44
"c:\Users\edwar\OneDrive\Documents\Programming\Visual Studio 2022\PARTS_Web\app\env_test\Lib\site-packages\pip\_internal\utils\egg_link.py", "Python", 0, 0, 0, -60, 0, 0, -13, -73
"c:\Users\edwar\OneDrive\Documents\Programming\Visual Studio 2022\PARTS_Web\app\env_test\Lib\site-packages\pip\_internal\utils\encoding.py", "Python", 0, 0, 0, -30, 0, -1, -6, -37
"c:\Users\edwar\OneDrive\Documents\Programming\Visual Studio 2022\PARTS_Web\app\env_test\Lib\site-packages\pip\_internal\utils\entrypoints.py", "Python", 0, 0, 0, -65, 0, -5, -15, -85
"c:\Users\edwar\OneDrive\Documents\Programming\Visual Studio 2022\PARTS_Web\app\env_test\Lib\site-packages\pip\_internal\utils\filesystem.py", "Python", 0, 0, 0, -104, 0, -18, -32, -154
"c:\Users\edwar\OneDrive\Documents\Programming\Visual Studio 2022\PARTS_Web\app\env_test\Lib\site-packages\pip\_internal\utils\filetypes.py", "Python", 0, 0, 0, -22, 0, 0, -6, -28
"c:\Users\edwar\OneDrive\Documents\Programming\Visual Studio 2022\PARTS_Web\app\env_test\Lib\site-packages\pip\_internal\utils\glibc.py", "Python", 0, 0, 0, -41, 0, -33, -15, -89
"c:\Users\edwar\OneDrive\Documents\Programming\Visual Studio 2022\PARTS_Web\app\env_test\Lib\site-packages\pip\_internal\utils\hashes.py", "Python", 0, 0, 0, -97, 0, -12, -36, -145
"c:\Users\edwar\OneDrive\Documents\Programming\Visual Studio 2022\PARTS_Web\app\env_test\Lib\site-packages\pip\_internal\utils\inject_securetransport.py", "Python", 0, 0, 0, -22, 0, -2, -12, -36
"c:\Users\edwar\OneDrive\Documents\Programming\Visual Studio 2022\PARTS_Web\app\env_test\Lib\site-packages\pip\_internal\utils\logging.py", "Python", 0, 0, 0, -273, 0, -22, -54, -349
"c:\Users\edwar\OneDrive\Documents\Programming\Visual Studio 2022\PARTS_Web\app\env_test\Lib\site-packages\pip\_internal\utils\misc.py", "Python", 0, 0, 0, -559, 0, -27, -154, -740
"c:\Users\edwar\OneDrive\Documents\Programming\Visual Studio 2022\PARTS_Web\app\env_test\Lib\site-packages\pip\_internal\utils\models.py", "Python", 0, 0, 0, -26, 0, 0, -14, -40
"c:\Users\edwar\OneDrive\Documents\Programming\Visual Studio 2022\PARTS_Web\app\env_test\Lib\site-packages\pip\_internal\utils\packaging.py", "Python", 0, 0, 0, -36, 0, -6, -16, -58
"c:\Users\edwar\OneDrive\Documents\Programming\Visual Studio 2022\PARTS_Web\app\env_test\Lib\site-packages\pip\_internal\utils\setuptools_build.py", "Python", 0, 0, 0, -146, 0, -16, -34, -196
"c:\Users\edwar\OneDrive\Documents\Programming\Visual Studio 2022\PARTS_Web\app\env_test\Lib\site-packages\pip\_internal\utils\subprocess.py", "Python", 0, 0, 0, -197, 0, -39, -25, -261
"c:\Users\edwar\OneDrive\Documents\Programming\Visual Studio 2022\PARTS_Web\app\env_test\Lib\site-packages\pip\_internal\utils\temp_dir.py", "Python", 0, 0, 0, -175, 0, -20, -52, -247
"c:\Users\edwar\OneDrive\Documents\Programming\Visual Studio 2022\PARTS_Web\app\env_test\Lib\site-packages\pip\_internal\utils\unpacking.py", "Python", 0, 0, 0, -215, 0, -14, -29, -258
"c:\Users\edwar\OneDrive\Documents\Programming\Visual Studio 2022\PARTS_Web\app\env_test\Lib\site-packages\pip\_internal\utils\urls.py", "Python", 0, 0, 0, -45, 0, -5, -13, -63
"c:\Users\edwar\OneDrive\Documents\Programming\Visual Studio 2022\PARTS_Web\app\env_test\Lib\site-packages\pip\_internal\utils\virtualenv.py", "Python", 0, 0, 0, -72, 0, -7, -26, -105
"c:\Users\edwar\OneDrive\Documents\Programming\Visual Studio 2022\PARTS_Web\app\env_test\Lib\site-packages\pip\_internal\utils\wheel.py", "Python", 0, 0, 0, -94, 0, -7, -36, -137
"c:\Users\edwar\OneDrive\Documents\Programming\Visual Studio 2022\PARTS_Web\app\env_test\Lib\site-packages\pip\_internal\vcs\__init__.py", "Python", 0, 0, 0, -11, 0, -4, -1, -16
"c:\Users\edwar\OneDrive\Documents\Programming\Visual Studio 2022\PARTS_Web\app\env_test\Lib\site-packages\pip\_internal\vcs\bazaar.py", "Python", 0, 0, 0, -94, 0, -3, -16, -113
"c:\Users\edwar\OneDrive\Documents\Programming\Visual Studio 2022\PARTS_Web\app\env_test\Lib\site-packages\pip\_internal\vcs\git.py", "Python", 0, 0, 0, -402, 0, -56, -69, -527
"c:\Users\edwar\OneDrive\Documents\Programming\Visual Studio 2022\PARTS_Web\app\env_test\Lib\site-packages\pip\_internal\vcs\mercurial.py", "Python", 0, 0, 0, -146, 0, -1, -17, -164
"c:\Users\edwar\OneDrive\Documents\Programming\Visual Studio 2022\PARTS_Web\app\env_test\Lib\site-packages\pip\_internal\vcs\subversion.py", "Python", 0, 0, 0, -237, 0, -40, -48, -325
"c:\Users\edwar\OneDrive\Documents\Programming\Visual Studio 2022\PARTS_Web\app\env_test\Lib\site-packages\pip\_internal\vcs\versioncontrol.py", "Python", 0, 0, 0, -570, 0, -23, -113, -706
"c:\Users\edwar\OneDrive\Documents\Programming\Visual Studio 2022\PARTS_Web\app\env_test\Lib\site-packages\pip\_internal\wheel_builder.py", "Python", 0, 0, 0, -309, 0, -25, -49, -383
"c:\Users\edwar\OneDrive\Documents\Programming\Visual Studio 2022\PARTS_Web\app\env_test\Lib\site-packages\pip\_vendor\__init__.py", "Python", 0, 0, 0, -84, 0, -26, -11, -121
"c:\Users\edwar\OneDrive\Documents\Programming\Visual Studio 2022\PARTS_Web\app\env_test\Lib\site-packages\pip\_vendor\cachecontrol\__init__.py", "Python", 0, 0, 0, -11, 0, -3, -5, -19
"c:\Users\edwar\OneDrive\Documents\Programming\Visual Studio 2022\PARTS_Web\app\env_test\Lib\site-packages\pip\_vendor\cachecontrol\_cmd.py", "Python", 0, 0, 0, -35, 0, -7, -20, -62
"c:\Users\edwar\OneDrive\Documents\Programming\Visual Studio 2022\PARTS_Web\app\env_test\Lib\site-packages\pip\_vendor\cachecontrol\adapter.py", "Python", 0, 0, 0, -92, 0, -20, -26, -138
"c:\Users\edwar\OneDrive\Documents\Programming\Visual Studio 2022\PARTS_Web\app\env_test\Lib\site-packages\pip\_vendor\cachecontrol\cache.py", "Python", 0, 0, 0, -43, 0, -3, -20, -66
"c:\Users\edwar\OneDrive\Documents\Programming\Visual Studio 2022\PARTS_Web\app\env_test\Lib\site-packages\pip\_vendor\cachecontrol\caches\__init__.py", "Python", 0, 0, 0, -3, 0, -3, -4, -10
"c:\Users\edwar\OneDrive\Documents\Programming\Visual Studio 2022\PARTS_Web\app\env_test\Lib\site-packages\pip\_vendor\cachecontrol\caches\file_cache.py", "Python", 0, 0, 0, -126, 0, -24, -39, -189
"c:\Users\edwar\OneDrive\Documents\Programming\Visual Studio 2022\PARTS_Web\app\env_test\Lib\site-packages\pip\_vendor\cachecontrol\caches\redis_cache.py", "Python", 0, 0, 0, -26, 0, -3, -11, -40
"c:\Users\edwar\OneDrive\Documents\Programming\Visual Studio 2022\PARTS_Web\app\env_test\Lib\site-packages\pip\_vendor\cachecontrol\compat.py", "Python", 0, 0, 0, -20, 0, -6, -7, -33
"c:\Users\edwar\OneDrive\Documents\Programming\Visual Studio 2022\PARTS_Web\app\env_test\Lib\site-packages\pip\_vendor\cachecontrol\controller.py", "Python", 0, 0, 0, -297, 0, -66, -77, -440
"c:\Users\edwar\OneDrive\Documents\Programming\Visual Studio 2022\PARTS_Web\app\env_test\Lib\site-packages\pip\_vendor\cachecontrol\filewrapper.py", "Python", 0, 0, 0, -61, 0, -29, -22, -112
"c:\Users\edwar\OneDrive\Documents\Programming\Visual Studio 2022\PARTS_Web\app\env_test\Lib\site-packages\pip\_vendor\cachecontrol\heuristics.py", "Python", 0, 0, 0, -98, 0, -3, -39, -140
"c:\Users\edwar\OneDrive\Documents\Programming\Visual Studio 2022\PARTS_Web\app\env_test\Lib\site-packages\pip\_vendor\cachecontrol\serialize.py", "Python", 0, 0, 0, -111, 0, -42, -38, -191
"c:\Users\edwar\OneDrive\Documents\Programming\Visual Studio 2022\PARTS_Web\app\env_test\Lib\site-packages\pip\_vendor\cachecontrol\wrapper.py", "Python", 0, 0, 0, -25, 0, -3, -6, -34
"c:\Users\edwar\OneDrive\Documents\Programming\Visual Studio 2022\PARTS_Web\app\env_test\Lib\site-packages\pip\_vendor\certifi\__init__.py", "Python", 0, 0, 0, -3, 0, 0, -2, -5
"c:\Users\edwar\OneDrive\Documents\Programming\Visual Studio 2022\PARTS_Web\app\env_test\Lib\site-packages\pip\_vendor\certifi\__main__.py", "Python", 0, 0, 0, -9, 0, 0, -4, -13
"c:\Users\edwar\OneDrive\Documents\Programming\Visual Studio 2022\PARTS_Web\app\env_test\Lib\site-packages\pip\_vendor\certifi\core.py", "Python", 0, 0, 0, -51, 0, -37, -21, -109
"c:\Users\edwar\OneDrive\Documents\Programming\Visual Studio 2022\PARTS_Web\app\env_test\Lib\site-packages\pip\_vendor\chardet\__init__.py", "Python", 0, 0, 0, -84, 0, -19, -13, -116
"c:\Users\edwar\OneDrive\Documents\Programming\Visual Studio 2022\PARTS_Web\app\env_test\Lib\site-packages\pip\_vendor\chardet\big5freq.py", "Python", 0, 0, 0, -340, 0, -43, -4, -387
"c:\Users\edwar\OneDrive\Documents\Programming\Visual Studio 2022\PARTS_Web\app\env_test\Lib\site-packages\pip\_vendor\chardet\big5prober.py", "Python", 0, 0, 0, -16, 0, -26, -6, -48
"c:\Users\edwar\OneDrive\Documents\Programming\Visual Studio 2022\PARTS_Web\app\env_test\Lib\site-packages\pip\_vendor\chardet\chardistribution.py", "Python", 0, 0, 0, -158, 0, -70, -34, -262
"c:\Users\edwar\OneDrive\Documents\Programming\Visual Studio 2022\PARTS_Web\app\env_test\Lib\site-packages\pip\_vendor\chardet\charsetgroupprober.py", "Python", 0, 0, 0, -71, 0, -26, -10, -107
"c:\Users\edwar\OneDrive\Documents\Programming\Visual Studio 2022\PARTS_Web\app\env_test\Lib\site-packages\pip\_vendor\chardet\charsetprober.py", "Python", 0, 0, 0, -80, 0, -43, -25, -148
"c:\Users\edwar\OneDrive\Documents\Programming\Visual Studio 2022\PARTS_Web\app\env_test\Lib\site-packages\pip\_vendor\chardet\cli\__init__.py", "Python", 0, 0, 0, 0, 0, 0, -1, -1
"c:\Users\edwar\OneDrive\Documents\Programming\Visual Studio 2022\PARTS_Web\app\env_test\Lib\site-packages\pip\_vendor\chardet\cli\chardetect.py", "Python", 0, 0, 0, -94, 0, -2, -17, -113
"c:\Users\edwar\OneDrive\Documents\Programming\Visual Studio 2022\PARTS_Web\app\env_test\Lib\site-packages\pip\_vendor\chardet\codingstatemachine.py", "Python", 0, 0, 0, -48, 0, -29, -14, -91
"c:\Users\edwar\OneDrive\Documents\Programming\Visual Studio 2022\PARTS_Web\app\env_test\Lib\site-packages\pip\_vendor\chardet\codingstatemachinedict.py", "Python", 0, 0, 0, -12, 0, -4, -4, -20
"c:\Users\edwar\OneDrive\Documents\Programming\Visual Studio 2022\PARTS_Web\app\env_test\Lib\site-packages\pip\_vendor\chardet\cp949prober.py", "Python", 0, 0, 0, -16, 0, -28, -6, -50
"c:\Users\edwar\OneDrive\Documents\Programming\Visual Studio 2022\PARTS_Web\app\env_test\Lib\site-packages\pip\_vendor\chardet\enums.py", "Python", 0, 0, 0, -63, 0, 0, -23, -86
"c:\Users\edwar\OneDrive\Documents\Programming\Visual Studio 2022\PARTS_Web\app\env_test\Lib\site-packages\pip\_vendor\chardet\escprober.py", "Python", 0, 0, 0, -65, 0, -26, -12, -103
"c:\Users\edwar\OneDrive\Documents\Programming\Visual Studio 2022\PARTS_Web\app\env_test\Lib\site-packages\pip\_vendor\chardet\escsm.py", "Python", 0, 0, 0, -210, 0, -34, -18, -262
"c:\Users\edwar\OneDrive\Documents\Programming\Visual Studio 2022\PARTS_Web\app\env_test\Lib\site-packages\pip\_vendor\chardet\eucjpprober.py", "Python", 0, 0, 0, -61, 0, -27, -15, -103
"c:\Users\edwar\OneDrive\Documents\Programming\Visual Studio 2022\PARTS_Web\app\env_test\Lib\site-packages\pip\_vendor\chardet\euckrfreq.py", "Python", 0, 0, 0, -151, 0, -40, -6, -197
"c:\Users\edwar\OneDrive\Documents\Programming\Visual Studio 2022\PARTS_Web\app\env_test\Lib\site-packages\pip\_vendor\chardet\euckrprober.py", "Python", 0, 0, 0, -16, 0, -26, -6, -48
"c:\Users\edwar\OneDrive\Documents\Programming\Visual Studio 2022\PARTS_Web\app\env_test\Lib\site-packages\pip\_vendor\chardet\euctwfreq.py", "Python", 0, 0, 0, -340, 0, -43, -6, -389
"c:\Users\edwar\OneDrive\Documents\Programming\Visual Studio 2022\PARTS_Web\app\env_test\Lib\site-packages\pip\_vendor\chardet\euctwprober.py", "Python", 0, 0, 0, -16, 0, -26, -6, -48
"c:\Users\edwar\OneDrive\Documents\Programming\Visual Studio 2022\PARTS_Web\app\env_test\Lib\site-packages\pip\_vendor\chardet\gb2312freq.py", "Python", 0, 0, 0, -239, 0, -40, -6, -285
"c:\Users\edwar\OneDrive\Documents\Programming\Visual Studio 2022\PARTS_Web\app\env_test\Lib\site-packages\pip\_vendor\chardet\gb2312prober.py", "Python", 0, 0, 0, -16, 0, -26, -6, -48
"c:\Users\edwar\OneDrive\Documents\Programming\Visual Studio 2022\PARTS_Web\app\env_test\Lib\site-packages\pip\_vendor\chardet\hebrewprober.py", "Python", 0, 0, 0, -103, 0, -186, -28, -317
"c:\Users\edwar\OneDrive\Documents\Programming\Visual Studio 2022\PARTS_Web\app\env_test\Lib\site-packages\pip\_vendor\chardet\jisfreq.py", "Python", 0, 0, 0, -277, 0, -43, -6, -326
"c:\Users\edwar\OneDrive\Documents\Programming\Visual Studio 2022\PARTS_Web\app\env_test\Lib\site-packages\pip\_vendor\chardet\johabfreq.py", "Python", 0, 0, 0, -2352, 0, -28, -3, -2383
"c:\Users\edwar\OneDrive\Documents\Programming\Visual Studio 2022\PARTS_Web\app\env_test\Lib\site-packages\pip\_vendor\chardet\johabprober.py", "Python", 0, 0, 0, -16, 0, -26, -6, -48
"c:\Users\edwar\OneDrive\Documents\Programming\Visual Studio 2022\PARTS_Web\app\env_test\Lib\site-packages\pip\_vendor\chardet\jpcntx.py", "Python", 0, 0, 0, -171, 0, -46, -22, -239
"c:\Users\edwar\OneDrive\Documents\Programming\Visual Studio 2022\PARTS_Web\app\env_test\Lib\site-packages\pip\_vendor\chardet\langbulgarianmodel.py", "Python", 0, 0, 0, -4632, 0, -10, -8, -4650
"c:\Users\edwar\OneDrive\Documents\Programming\Visual Studio 2022\PARTS_Web\app\env_test\Lib\site-packages\pip\_vendor\chardet\langgreekmodel.py", "Python", 0, 0, 0, -4380, 0, -10, -8, -4398
"c:\Users\edwar\OneDrive\Documents\Programming\Visual Studio 2022\PARTS_Web\app\env_test\Lib\site-packages\pip\_vendor\chardet\langhebrewmodel.py", "Python", 0, 0, 0, -4365, 0, -10, -6, -4381
"c:\Users\edwar\OneDrive\Documents\Programming\Visual Studio 2022\PARTS_Web\app\env_test\Lib\site-packages\pip\_vendor\chardet\langhungarianmodel.py", "Python", 0, 0, 0, -4632, 0, -10, -8, -4650
"c:\Users\edwar\OneDrive\Documents\Programming\Visual Studio 2022\PARTS_Web\app\env_test\Lib\site-packages\pip\_vendor\chardet\langrussianmodel.py", "Python", 0, 0, 0, -5700, 0, -10, -16, -5726
"c:\Users\edwar\OneDrive\Documents\Programming\Visual Studio 2022\PARTS_Web\app\env_test\Lib\site-packages\pip\_vendor\chardet\langthaimodel.py", "Python", 0, 0, 0, -4365, 0, -10, -6, -4381
"c:\Users\edwar\OneDrive\Documents\Programming\Visual Studio 2022\PARTS_Web\app\env_test\Lib\site-packages\pip\_vendor\chardet\langturkishmodel.py", "Python", 0, 0, 0, -4365, 0, -10, -6, -4381
"c:\Users\edwar\OneDrive\Documents\Programming\Visual Studio 2022\PARTS_Web\app\env_test\Lib\site-packages\pip\_vendor\chardet\latin1prober.py", "Python", 0, 0, 0, -96, 0, -36, -16, -148
"c:\Users\edwar\OneDrive\Documents\Programming\Visual Studio 2022\PARTS_Web\app\env_test\Lib\site-packages\pip\_vendor\chardet\macromanprober.py", "Python", 0, 0, 0, -99, 0, -45, -19, -163
"c:\Users\edwar\OneDrive\Documents\Programming\Visual Studio 2022\PARTS_Web\app\env_test\Lib\site-packages\pip\_vendor\chardet\mbcharsetprober.py", "Python", 0, 0, 0, -55, 0, -28, -13, -96
"c:\Users\edwar\OneDrive\Documents\Programming\Visual Studio 2022\PARTS_Web\app\env_test\Lib\site-packages\pip\_vendor\chardet\mbcsgroupprober.py", "Python", 0, 0, 0, -26, 0, -28, -4, -58
"c:\Users\edwar\OneDrive\Documents\Programming\Visual Studio 2022\PARTS_Web\app\env_test\Lib\site-packages\pip\_vendor\chardet\mbcssm.py", "Python", 0, 0, 0, -547, 0, -68, -47, -662
"c:\Users\edwar\OneDrive\Documents\Programming\Visual Studio 2022\PARTS_Web\app\env_test\Lib\site-packages\pip\_vendor\chardet\metadata\__init__.py", "Python", 0, 0, 0, 0, 0, 0, -1, -1
"c:\Users\edwar\OneDrive\Documents\Programming\Visual Studio 2022\PARTS_Web\app\env_test\Lib\site-packages\pip\_vendor\chardet\metadata\languages.py", "Python", 0, 0, 0, -308, 0, -34, -11, -353
"c:\Users\edwar\OneDrive\Documents\Programming\Visual Studio 2022\PARTS_Web\app\env_test\Lib\site-packages\pip\_vendor\chardet\resultdict.py", "Python", 0, 0, 0, -9, 0, -4, -4, -17
"c:\Users\edwar\OneDrive\Documents\Programming\Visual Studio 2022\PARTS_Web\app\env_test\Lib\site-packages\pip\_vendor\chardet\sbcharsetprober.py", "Python", 0, 0, 0, -108, 0, -40, -15, -163
"c:\Users\edwar\OneDrive\Documents\Programming\Visual Studio 2022\PARTS_Web\app\env_test\Lib\site-packages\pip\_vendor\chardet\sbcsgroupprober.py", "Python", 0, 0, 0, -45, 0, -39, -5, -89
"c:\Users\edwar\OneDrive\Documents\Programming\Visual Studio 2022\PARTS_Web\app\env_test\Lib\site-packages\pip\_vendor\chardet\sjisprober.py", "Python", 0, 0, 0, -65, 0, -26, -15, -106
"c:\Users\edwar\OneDrive\Documents\Programming\Visual Studio 2022\PARTS_Web\app\env_test\Lib\site-packages\pip\_vendor\chardet\universaldetector.py", "Python", 0, 0, 0, -265, 0, -63, -35, -363
"c:\Users\edwar\OneDrive\Documents\Programming\Visual Studio 2022\PARTS_Web\app\env_test\Lib\site-packages\pip\_vendor\chardet\utf1632prober.py", "Python", 0, 0, 0, -175, 0, -26, -25, -226
"c:\Users\edwar\OneDrive\Documents\Programming\Visual Studio 2022\PARTS_Web\app\env_test\Lib\site-packages\pip\_vendor\chardet\utf8prober.py", "Python", 0, 0, 0, -44, 0, -26, -13, -83
"c:\Users\edwar\OneDrive\Documents\Programming\Visual Studio 2022\PARTS_Web\app\env_test\Lib\site-packages\pip\_vendor\chardet\version.py", "Python", 0, 0, 0, -7, 0, 0, -3, -10
"c:\Users\edwar\OneDrive\Documents\Programming\Visual Studio 2022\PARTS_Web\app\env_test\Lib\site-packages\pip\_vendor\colorama\__init__.py", "Python", 0, 0, 0, -4, 0, -1, -3, -8
"c:\Users\edwar\OneDrive\Documents\Programming\Visual Studio 2022\PARTS_Web\app\env_test\Lib\site-packages\pip\_vendor\colorama\ansi.py", "Python", 0, 0, 0, -77, 0, -6, -20, -103
"c:\Users\edwar\OneDrive\Documents\Programming\Visual Studio 2022\PARTS_Web\app\env_test\Lib\site-packages\pip\_vendor\colorama\ansitowin32.py", "Python", 0, 0, 0, -209, 0, -25, -44, -278
"c:\Users\edwar\OneDrive\Documents\Programming\Visual Studio 2022\PARTS_Web\app\env_test\Lib\site-packages\pip\_vendor\colorama\initialise.py", "Python", 0, 0, 0, -83, 0, -8, -31, -122
"c:\Users\edwar\OneDrive\Documents\Programming\Visual Studio 2022\PARTS_Web\app\env_test\Lib\site-packages\pip\_vendor\colorama\tests\__init__.py", "Python", 0, 0, 0, 0, 0, -1, -1, -2
"c:\Users\edwar\OneDrive\Documents\Programming\Visual Studio 2022\PARTS_Web\app\env_test\Lib\site-packages\pip\_vendor\colorama\tests\ansi_test.py", "Python", 0, 0, 0, -55, 0, -5, -17, -77
"c:\Users\edwar\OneDrive\Documents\Programming\Visual Studio 2022\PARTS_Web\app\env_test\Lib\site-packages\pip\_vendor\colorama\tests\ansitowin32_test.py", "Python", 0, 0, 0, -243, 0, -8, -44, -295
"c:\Users\edwar\OneDrive\Documents\Programming\Visual Studio 2022\PARTS_Web\app\env_test\Lib\site-packages\pip\_vendor\colorama\tests\initialise_test.py", "Python", 0, 0, 0, -145, 0, -10, -35, -190
"c:\Users\edwar\OneDrive\Documents\Programming\Visual Studio 2022\PARTS_Web\app\env_test\Lib\site-packages\pip\_vendor\colorama\tests\isatty_test.py", "Python", 0, 0, 0, -43, 0, -1, -14, -58
"c:\Users\edwar\OneDrive\Documents\Programming\Visual Studio 2022\PARTS_Web\app\env_test\Lib\site-packages\pip\_vendor\colorama\tests\utils.py", "Python", 0, 0, 0, -41, 0, -1, -8, -50
"c:\Users\edwar\OneDrive\Documents\Programming\Visual Studio 2022\PARTS_Web\app\env_test\Lib\site-packages\pip\_vendor\colorama\tests\winterm_test.py", "Python", 0, 0, 0, -99, 0, -1, -32, -132
"c:\Users\edwar\OneDrive\Documents\Programming\Visual Studio 2022\PARTS_Web\app\env_test\Lib\site-packages\pip\_vendor\colorama\win32.py", "Python", 0, 0, 0, -146, 0, -10, -25, -181
"c:\Users\edwar\OneDrive\Documents\Programming\Visual Studio 2022\PARTS_Web\app\env_test\Lib\site-packages\pip\_vendor\colorama\winterm.py", "Python", 0, 0, 0, -143, 0, -29, -24, -196
"c:\Users\edwar\OneDrive\Documents\Programming\Visual Studio 2022\PARTS_Web\app\env_test\Lib\site-packages\pip\_vendor\distlib\__init__.py", "Python", 0, 0, 0, -13, 0, -6, -5, -24
"c:\Users\edwar\OneDrive\Documents\Programming\Visual Studio 2022\PARTS_Web\app\env_test\Lib\site-packages\pip\_vendor\distlib\compat.py", "Python", 0, 0, 0, -851, 0, -102, -164, -1117
"c:\Users\edwar\OneDrive\Documents\Programming\Visual Studio 2022\PARTS_Web\app\env_test\Lib\site-packages\pip\_vendor\distlib\database.py", "Python", 0, 0, 0, -1128, 0, -44, -179, -1351
"c:\Users\edwar\OneDrive\Documents\Programming\Visual Studio 2022\PARTS_Web\app\env_test\Lib\site-packages\pip\_vendor\distlib\index.py", "Python", 0, 0, 0, -446, 0, -19, -44, -509
"c:\Users\edwar\OneDrive\Documents\Programming\Visual Studio 2022\PARTS_Web\app\env_test\Lib\site-packages\pip\_vendor\distlib\locators.py", "Python", 0, 0, 0, -1108, 0, -80, -113, -1301
"c:\Users\edwar\OneDrive\Documents\Programming\Visual Studio 2022\PARTS_Web\app\env_test\Lib\site-packages\pip\_vendor\distlib\manifest.py", "Python", 0, 0, 0, -275, 0, -51, -68, -394
"c:\Users\edwar\OneDrive\Documents\Programming\Visual Studio 2022\PARTS_Web\app\env_test\Lib\site-packages\pip\_vendor\distlib\markers.py", "Python", 0, 0, 0, -124, 0, -9, -20, -153
"c:\Users\edwar\OneDrive\Documents\Programming\Visual Studio 2022\PARTS_Web\app\env_test\Lib\site-packages\pip\_vendor\distlib\metadata.py", "Python", 0, 0, 0, -847, 0, -74, -156, -1077
"c:\Users\edwar\OneDrive\Documents\Programming\Visual Studio 2022\PARTS_Web\app\env_test\Lib\site-packages\pip\_vendor\distlib\resources.py", "Python", 0, 0, 0, -280, 0, -15, -64, -359
"c:\Users\edwar\OneDrive\Documents\Programming\Visual Studio 2022\PARTS_Web\app\env_test\Lib\site-packages\pip\_vendor\distlib\scripts.py", "Python", 0, 0, 0, -347, 0, -48, -43, -438
"c:\Users\edwar\OneDrive\Documents\Programming\Visual Studio 2022\PARTS_Web\app\env_test\Lib\site-packages\pip\_vendor\distlib\util.py", "Python", 0, 0, 0, -1528, 0, -163, -242, -1933
"c:\Users\edwar\OneDrive\Documents\Programming\Visual Studio 2022\PARTS_Web\app\env_test\Lib\site-packages\pip\_vendor\distlib\version.py", "Python", 0, 0, 0, -524, 0, -87, -129, -740
"c:\Users\edwar\OneDrive\Documents\Programming\Visual Studio 2022\PARTS_Web\app\env_test\Lib\site-packages\pip\_vendor\distlib\wheel.py", "Python", 0, 0, 0, -902, 0, -74, -107, -1083
"c:\Users\edwar\OneDrive\Documents\Programming\Visual Studio 2022\PARTS_Web\app\env_test\Lib\site-packages\pip\_vendor\distro\__init__.py", "Python", 0, 0, 0, -52, 0, 0, -3, -55
"c:\Users\edwar\OneDrive\Documents\Programming\Visual Studio 2022\PARTS_Web\app\env_test\Lib\site-packages\pip\_vendor\distro\__main__.py", "Python", 0, 0, 0, -3, 0, 0, -2, -5
"c:\Users\edwar\OneDrive\Documents\Programming\Visual Studio 2022\PARTS_Web\app\env_test\Lib\site-packages\pip\_vendor\distro\distro.py", "Python", 0, 0, 0, -1035, 0, -90, -275, -1400
"c:\Users\edwar\OneDrive\Documents\Programming\Visual Studio 2022\PARTS_Web\app\env_test\Lib\site-packages\pip\_vendor\idna\__init__.py", "Python", 0, 0, 0, -43, 0, 0, -2, -45
"c:\Users\edwar\OneDrive\Documents\Programming\Visual Studio 2022\PARTS_Web\app\env_test\Lib\site-packages\pip\_vendor\idna\codec.py", "Python", 0, 0, 0, -84, 0, -4, -25, -113
"c:\Users\edwar\OneDrive\Documents\Programming\Visual Studio 2022\PARTS_Web\app\env_test\Lib\site-packages\pip\_vendor\idna\compat.py", "Python", 0, 0, 0, -9, 0, 0, -5, -14
"c:\Users\edwar\OneDrive\Documents\Programming\Visual Studio 2022\PARTS_Web\app\env_test\Lib\site-packages\pip\_vendor\idna\core.py", "Python", 0, 0, 0, -319, 0, -8, -74, -401
"c:\Users\edwar\OneDrive\Documents\Programming\Visual Studio 2022\PARTS_Web\app\env_test\Lib\site-packages\pip\_vendor\idna\idnadata.py", "Python", 0, 0, 0, -2149, 0, -1, -2, -2152
"c:\Users\edwar\OneDrive\Documents\Programming\Visual Studio 2022\PARTS_Web\app\env_test\Lib\site-packages\pip\_vendor\idna\intranges.py", "Python", 0, 0, 0, -42, 0, -3, -10, -55
"c:\Users\edwar\OneDrive\Documents\Programming\Visual Studio 2022\PARTS_Web\app\env_test\Lib\site-packages\pip\_vendor\idna\package_data.py", "Python", 0, 0, 0, -1, 0, 0, -2, -3
"c:\Users\edwar\OneDrive\Documents\Programming\Visual Studio 2022\PARTS_Web\app\env_test\Lib\site-packages\pip\_vendor\idna\uts46data.py", "Python", 0, 0, 0, -8511, 0, -2, -88, -8601
"c:\Users\edwar\OneDrive\Documents\Programming\Visual Studio 2022\PARTS_Web\app\env_test\Lib\site-packages\pip\_vendor\msgpack\__init__.py", "Python", 0, 0, 0, -38, 0, -2, -18, -58
"c:\Users\edwar\OneDrive\Documents\Programming\Visual Studio 2022\PARTS_Web\app\env_test\Lib\site-packages\pip\_vendor\msgpack\exceptions.py", "Python", 0, 0, 0, -28, 0, -2, -19, -49
"c:\Users\edwar\OneDrive\Documents\Programming\Visual Studio 2022\PARTS_Web\app\env_test\Lib\site-packages\pip\_vendor\msgpack\ext.py", "Python", 0, 0, 0, -149, 0, -4, -41, -194
"c:\Users\edwar\OneDrive\Documents\Programming\Visual Studio 2022\PARTS_Web\app\env_test\Lib\site-packages\pip\_vendor\msgpack\fallback.py", "Python", 0, 0, 0, -857, 0, -22, -132, -1011
"c:\Users\edwar\OneDrive\Documents\Programming\Visual Studio 2022\PARTS_Web\app\env_test\Lib\site-packages\pip\_vendor\packaging\__about__.py", "Python", 0, 0, 0, -18, 0, -3, -6, -27
"c:\Users\edwar\OneDrive\Documents\Programming\Visual Studio 2022\PARTS_Web\app\env_test\Lib\site-packages\pip\_vendor\packaging\__init__.py", "Python", 0, 0, 0, -20, 0, -3, -3, -26
"c:\Users\edwar\OneDrive\Documents\Programming\Visual Studio 2022\PARTS_Web\app\env_test\Lib\site-packages\pip\_vendor\packaging\_manylinux.py", "Python", 0, 0, 0, -212, 0, -51, -39, -302
"c:\Users\edwar\OneDrive\Documents\Programming\Visual Studio 2022\PARTS_Web\app\env_test\Lib\site-packages\pip\_vendor\packaging\_musllinux.py", "Python", 0, 0, 0, -107, 0, -4, -26, -137
"c:\Users\edwar\OneDrive\Documents\Programming\Visual Studio 2022\PARTS_Web\app\env_test\Lib\site-packages\pip\_vendor\packaging\_structures.py", "Python", 0, 0, 0, -36, 0, -3, -23, -62
"c:\Users\edwar\OneDrive\Documents\Programming\Visual Studio 2022\PARTS_Web\app\env_test\Lib\site-packages\pip\_vendor\packaging\markers.py", "Python", 0, 0, 0, -224, 0, -7, -74, -305
"c:\Users\edwar\OneDrive\Documents\Programming\Visual Studio 2022\PARTS_Web\app\env_test\Lib\site-packages\pip\_vendor\packaging\requirements.py", "Python", 0, 0, 0, -105, 0, -9, -33, -147
"c:\Users\edwar\OneDrive\Documents\Programming\Visual Studio 2022\PARTS_Web\app\env_test\Lib\site-packages\pip\_vendor\packaging\specifiers.py", "Python", 0, 0, 0, -490, 0, -156, -157, -803
"c:\Users\edwar\OneDrive\Documents\Programming\Visual Studio 2022\PARTS_Web\app\env_test\Lib\site-packages\pip\_vendor\packaging\tags.py", "Python", 0, 0, 0, -373, 0, -26, -89, -488
"c:\Users\edwar\OneDrive\Documents\Programming\Visual Studio 2022\PARTS_Web\app\env_test\Lib\site-packages\pip\_vendor\packaging\utils.py", "Python", 0, 0, 0, -91, 0, -16, -30, -137
"c:\Users\edwar\OneDrive\Documents\Programming\Visual Studio 2022\PARTS_Web\app\env_test\Lib\site-packages\pip\_vendor\packaging\version.py", "Python", 0, 0, 0, -334, 0, -58, -113, -505
"c:\Users\edwar\OneDrive\Documents\Programming\Visual Studio 2022\PARTS_Web\app\env_test\Lib\site-packages\pip\_vendor\pkg_resources\__init__.py", "Python", 0, 0, 0, -2472, 0, -168, -657, -3297
"c:\Users\edwar\OneDrive\Documents\Programming\Visual Studio 2022\PARTS_Web\app\env_test\Lib\site-packages\pip\_vendor\pkg_resources\py31compat.py", "Python", 0, 0, 0, -15, 0, -3, -6, -24
"c:\Users\edwar\OneDrive\Documents\Programming\Visual Studio 2022\PARTS_Web\app\env_test\Lib\site-packages\pip\_vendor\platformdirs\__init__.py", "Python", 0, 0, 0, -291, 0, 0, -52, -343
"c:\Users\edwar\OneDrive\Documents\Programming\Visual Studio 2022\PARTS_Web\app\env_test\Lib\site-packages\pip\_vendor\platformdirs\__main__.py", "Python", 0, 0, 0, -35, 0, 0, -12, -47
"c:\Users\edwar\OneDrive\Documents\Programming\Visual Studio 2022\PARTS_Web\app\env_test\Lib\site-packages\pip\_vendor\platformdirs\android.py", "Python", 0, 0, 0, -95, 0, -3, -23, -121
"c:\Users\edwar\OneDrive\Documents\Programming\Visual Studio 2022\PARTS_Web\app\env_test\Lib\site-packages\pip\_vendor\platformdirs\api.py", "Python", 0, 0, 0, -131, 0, 0, -26, -157
"c:\Users\edwar\OneDrive\Documents\Programming\Visual Studio 2022\PARTS_Web\app\env_test\Lib\site-packages\pip\_vendor\platformdirs\macos.py", "Python", 0, 0, 0, -49, 0, 0, -16, -65
"c:\Users\edwar\OneDrive\Documents\Programming\Visual Studio 2022\PARTS_Web\app\env_test\Lib\site-packages\pip\_vendor\platformdirs\unix.py", "Python", 0, 0, 0, -148, 0, -5, -29, -182
"c:\Users\edwar\OneDrive\Documents\Programming\Visual Studio 2022\PARTS_Web\app\env_test\Lib\site-packages\pip\_vendor\platformdirs\version.py", "Python", 0, 0, 0, -2, 0, -2, -1, -5
"c:\Users\edwar\OneDrive\Documents\Programming\Visual Studio 2022\PARTS_Web\app\env_test\Lib\site-packages\pip\_vendor\platformdirs\windows.py", "Python", 0, 0, 0, -152, 0, -1, -32, -185
"c:\Users\edwar\OneDrive\Documents\Programming\Visual Studio 2022\PARTS_Web\app\env_test\Lib\site-packages\pip\_vendor\pygments\__init__.py", "Python", 0, 0, 0, -64, 0, -2, -17, -83
"c:\Users\edwar\OneDrive\Documents\Programming\Visual Studio 2022\PARTS_Web\app\env_test\Lib\site-packages\pip\_vendor\pygments\__main__.py", "Python", 0, 0, 0, -13, 0, 0, -5, -18
"c:\Users\edwar\OneDrive\Documents\Programming\Visual Studio 2022\PARTS_Web\app\env_test\Lib\site-packages\pip\_vendor\pygments\cmdline.py", "Python", 0, 0, 0, -554, 0, -39, -76, -669
"c:\Users\edwar\OneDrive\Documents\Programming\Visual Studio 2022\PARTS_Web\app\env_test\Lib\site-packages\pip\_vendor\pygments\console.py", "Python", 0, 0, 0, -54, 0, 0, -17, -71
"c:\Users\edwar\OneDrive\Documents\Programming\Visual Studio 2022\PARTS_Web\app\env_test\Lib\site-packages\pip\_vendor\pygments\filter.py", "Python", 0, 0, 0, -55, 0, -1, -16, -72
"c:\Users\edwar\OneDrive\Documents\Programming\Visual Studio 2022\PARTS_Web\app\env_test\Lib\site-packages\pip\_vendor\pygments\filters\__init__.py", "Python", 0, 0, 0, -858, 0, -3, -80, -941
"c:\Users\edwar\OneDrive\Documents\Programming\Visual Studio 2022\PARTS_Web\app\env_test\Lib\site-packages\pip\_vendor\pygments\formatter.py", "Python", 0, 0, 0, -68, 0, -7, -20, -95
"c:\Users\edwar\OneDrive\Documents\Programming\Visual Studio 2022\PARTS_Web\app\env_test\Lib\site-packages\pip\_vendor\pygments\formatters\__init__.py", "Python", 0, 0, 0, -110, 0, -4, -30, -144
"c:\Users\edwar\OneDrive\Documents\Programming\Visual Studio 2022\PARTS_Web\app\env_test\Lib\site-packages\pip\_vendor\pygments\formatters\_mapping.py", "Python", 0, 0, 0, -20, 0, -2, -2, -24
"c:\Users\edwar\OneDrive\Documents\Programming\Visual Studio 2022\PARTS_Web\app\env_test\Lib\site-packages\pip\_vendor\pygments\formatters\bbcode.py", "Python", 0, 0, 0, -85, 0, -1, -23, -109
"c:\Users\edwar\OneDrive\Documents\Programming\Visual Studio 2022\PARTS_Web\app\env_test\Lib\site-packages\pip\_vendor\pygments\formatters\groff.py", "Python", 0, 0, 0, -128, 0, 0, -43, -171
"c:\Users\edwar\OneDrive\Documents\Programming\Visual Studio 2022\PARTS_Web\app\env_test\Lib\site-packages\pip\_vendor\pygments\formatters\html.py", "Python", 0, 0, 0, -790, 0, -21, -179, -990
"c:\Users\edwar\OneDrive\Documents\Programming\Visual Studio 2022\PARTS_Web\app\env_test\Lib\site-packages\pip\_vendor\pygments\formatters\img.py", "Python", 0, 0, 0, -520, 0, -22, -104, -646
"c:\Users\edwar\OneDrive\Documents\Programming\Visual Studio 2022\PARTS_Web\app\env_test\Lib\site-packages\pip\_vendor\pygments\formatters\irc.py", "Python", 0, 0, 0, -148, 0, -4, -28, -180
"c:\Users\edwar\OneDrive\Documents\Programming\Visual Studio 2022\PARTS_Web\app\env_test\Lib\site-packages\pip\_vendor\pygments\formatters\latex.py", "Python", 0, 0, 0, -405, 0, -45, -72, -522
"c:\Users\edwar\OneDrive\Documents\Programming\Visual Studio 2022\PARTS_Web\app\env_test\Lib\site-packages\pip\_vendor\pygments\formatters\other.py", "Python", 0, 0, 0, -129, 0, -3, -30, -162
"c:\Users\edwar\OneDrive\Documents\Programming\Visual Studio 2022\PARTS_Web\app\env_test\Lib\site-packages\pip\_vendor\pygments\formatters\pangomarkup.py", "Python", 0, 0, 0, -62, 0, 0, -22, -84
"c:\Users\edwar\OneDrive\Documents\Programming\Visual Studio 2022\PARTS_Web\app\env_test\Lib\site-packages\pip\_vendor\pygments\formatters\rtf.py", "Python", 0, 0, 0, -111, 0, -9, -27, -147
"c:\Users\edwar\OneDrive\Documents\Programming\Visual Studio 2022\PARTS_Web\app\env_test\Lib\site-packages\pip\_vendor\pygments\formatters\svg.py", "Python", 0, 0, 0, -156, 0, 0, -33, -189
"c:\Users\edwar\OneDrive\Documents\Programming\Visual Studio 2022\PARTS_Web\app\env_test\Lib\site-packages\pip\_vendor\pygments\formatters\terminal.py", "Python", 0, 0, 0, -97, 0, -5, -26, -128
"c:\Users\edwar\OneDrive\Documents\Programming\Visual Studio 2022\PARTS_Web\app\env_test\Lib\site-packages\pip\_vendor\pygments\formatters\terminal256.py", "Python", 0, 0, 0, -255, 0, -21, -63, -339
"c:\Users\edwar\OneDrive\Documents\Programming\Visual Studio 2022\PARTS_Web\app\env_test\Lib\site-packages\pip\_vendor\pygments\lexer.py", "Python", 0, 0, 0, -679, 0, -76, -128, -883
"c:\Users\edwar\OneDrive\Documents\Programming\Visual Studio 2022\PARTS_Web\app\env_test\Lib\site-packages\pip\_vendor\pygments\lexers\__init__.py", "Python", 0, 0, 0, -252, 0, -22, -62, -336
"c:\Users\edwar\OneDrive\Documents\Programming\Visual Studio 2022\PARTS_Web\app\env_test\Lib\site-packages\pip\_vendor\pygments\lexers\_mapping.py", "Python", 0, 0, 0, -538, 0, -2, -2, -542
"c:\Users\edwar\OneDrive\Documents\Programming\Visual Studio 2022\PARTS_Web\app\env_test\Lib\site-packages\pip\_vendor\pygments\lexers\python.py", "Python", 0, 0, 0, -1070, 0, -58, -77, -1205
"c:\Users\edwar\OneDrive\Documents\Programming\Visual Studio 2022\PARTS_Web\app\env_test\Lib\site-packages\pip\_vendor\pygments\modeline.py", "Python", 0, 0, 0, -32, 0, 0, -12, -44
"c:\Users\edwar\OneDrive\Documents\Programming\Visual Studio 2022\PARTS_Web\app\env_test\Lib\site-packages\pip\_vendor\pygments\plugin.py", "Python", 0, 0, 0, -61, 0, -4, -24, -89
"c:\Users\edwar\OneDrive\Documents\Programming\Visual Studio 2022\PARTS_Web\app\env_test\Lib\site-packages\pip\_vendor\pygments\regexopt.py", "Python", 0, 0, 0, -66, 0, -13, -13, -92
"c:\Users\edwar\OneDrive\Documents\Programming\Visual Studio 2022\PARTS_Web\app\env_test\Lib\site-packages\pip\_vendor\pygments\scanner.py", "Python", 0, 0, 0, -89, 0, 0, -16, -105
"c:\Users\edwar\OneDrive\Documents\Programming\Visual Studio 2022\PARTS_Web\app\env_test\Lib\site-packages\pip\_vendor\pygments\sphinxext.py", "Python", 0, 0, 0, -124, 0, 0, -32, -156
"c:\Users\edwar\OneDrive\Documents\Programming\Visual Studio 2022\PARTS_Web\app\env_test\Lib\site-packages\pip\_vendor\pygments\style.py", "Python", 0, 0, 0, -153, 0, -17, -28, -198
"c:\Users\edwar\OneDrive\Documents\Programming\Visual Studio 2022\PARTS_Web\app\env_test\Lib\site-packages\pip\_vendor\pygments\styles\__init__.py", "Python", 0, 0, 0, -85, 0, -2, -11, -98
"c:\Users\edwar\OneDrive\Documents\Programming\Visual Studio 2022\PARTS_Web\app\env_test\Lib\site-packages\pip\_vendor\pygments\token.py", "Python", 0, 0, 0, -164, 0, -12, -38, -214
"c:\Users\edwar\OneDrive\Documents\Programming\Visual Studio 2022\PARTS_Web\app\env_test\Lib\site-packages\pip\_vendor\pygments\unistring.py", "Python", 0, 0, 0, -94, 0, -6, -54, -154
"c:\Users\edwar\OneDrive\Documents\Programming\Visual Studio 2022\PARTS_Web\app\env_test\Lib\site-packages\pip\_vendor\pygments\util.py", "Python", 0, 0, 0, -246, 0, -5, -58, -309
"c:\Users\edwar\OneDrive\Documents\Programming\Visual Studio 2022\PARTS_Web\app\env_test\Lib\site-packages\pip\_vendor\pyparsing\__init__.py", "Python", 0, 0, 0, -277, 0, -26, -29, -332
"c:\Users\edwar\OneDrive\Documents\Programming\Visual Studio 2022\PARTS_Web\app\env_test\Lib\site-packages\pip\_vendor\pyparsing\actions.py", "Python", 0, 0, 0, -148, 0, -6, -54, -208
"c:\Users\edwar\OneDrive\Documents\Programming\Visual Studio 2022\PARTS_Web\app\env_test\Lib\site-packages\pip\_vendor\pyparsing\common.py", "Python", 0, 0, 0, -304, 0, -39, -82, -425
"c:\Users\edwar\OneDrive\Documents\Programming\Visual Studio 2022\PARTS_Web\app\env_test\Lib\site-packages\pip\_vendor\pyparsing\core.py", "Python", 0, 0, 0, -4609, 0, -252, -954, -5815
"c:\Users\edwar\OneDrive\Documents\Programming\Visual Studio 2022\PARTS_Web\app\env_test\Lib\site-packages\pip\_vendor\pyparsing\diagram\__init__.py", "Python", 0, 0, 0, -503, 0, -58, -82, -643
"c:\Users\edwar\OneDrive\Documents\Programming\Visual Studio 2022\PARTS_Web\app\env_test\Lib\site-packages\pip\_vendor\pyparsing\exceptions.py", "Python", 0, 0, 0, -207, 0, -4, -57, -268
"c:\Users\edwar\OneDrive\Documents\Programming\Visual Studio 2022\PARTS_Web\app\env_test\Lib\site-packages\pip\_vendor\pyparsing\helpers.py", "Python", 0, 0, 0, -872, 0, -38, -179, -1089
"c:\Users\edwar\OneDrive\Documents\Programming\Visual Studio 2022\PARTS_Web\app\env_test\Lib\site-packages\pip\_vendor\pyparsing\results.py", "Python", 0, 0, 0, -609, 0, -24, -128, -761
"c:\Users\edwar\OneDrive\Documents\Programming\Visual Studio 2022\PARTS_Web\app\env_test\Lib\site-packages\pip\_vendor\pyparsing\testing.py", "Python", 0, 0, 0, -279, 0, -10, -43, -332
"c:\Users\edwar\OneDrive\Documents\Programming\Visual Studio 2022\PARTS_Web\app\env_test\Lib\site-packages\pip\_vendor\pyparsing\unicode.py", "Python", 0, 0, 0, -300, 0, -5, -48, -353
"c:\Users\edwar\OneDrive\Documents\Programming\Visual Studio 2022\PARTS_Web\app\env_test\Lib\site-packages\pip\_vendor\pyparsing\util.py", "Python", 0, 0, 0, -184, 0, -2, -50, -236
"c:\Users\edwar\OneDrive\Documents\Programming\Visual Studio 2022\PARTS_Web\app\env_test\Lib\site-packages\pip\_vendor\pyproject_hooks\__init__.py", "Python", 0, 0, 0, -21, 0, 0, -3, -24
"c:\Users\edwar\OneDrive\Documents\Programming\Visual Studio 2022\PARTS_Web\app\env_test\Lib\site-packages\pip\_vendor\pyproject_hooks\_compat.py", "Python", 0, 0, 0, -6, 0, 0, -3, -9
"c:\Users\edwar\OneDrive\Documents\Programming\Visual Studio 2022\PARTS_Web\app\env_test\Lib\site-packages\pip\_vendor\pyproject_hooks\_impl.py", "Python", 0, 0, 0, -258, 0, -4, -69, -331
"c:\Users\edwar\OneDrive\Documents\Programming\Visual Studio 2022\PARTS_Web\app\env_test\Lib\site-packages\pip\_vendor\pyproject_hooks\_in_process\__init__.py", "Python", 0, 0, 0, -14, 0, -1, -4, -19
"c:\Users\edwar\OneDrive\Documents\Programming\Visual Studio 2022\PARTS_Web\app\env_test\Lib\site-packages\pip\_vendor\pyproject_hooks\_in_process\_in_process.py", "Python", 0, 0, 0, -274, 0, -6, -74, -354
"c:\Users\edwar\OneDrive\Documents\Programming\Visual Studio 2022\PARTS_Web\app\env_test\Lib\site-packages\pip\_vendor\requests\__init__.py", "Python", 0, 0, 0, -128, 0, -21, -34, -183
"c:\Users\edwar\OneDrive\Documents\Programming\Visual Studio 2022\PARTS_Web\app\env_test\Lib\site-packages\pip\_vendor\requests\__version__.py", "Python", 0, 0, 0, -10, 0, -3, -2, -15
"c:\Users\edwar\OneDrive\Documents\Programming\Visual Studio 2022\PARTS_Web\app\env_test\Lib\site-packages\pip\_vendor\requests\_internal_utils.py", "Python", 0, 0, 0, -38, 0, 0, -11, -49
"c:\Users\edwar\OneDrive\Documents\Programming\Visual Studio 2022\PARTS_Web\app\env_test\Lib\site-packages\pip\_vendor\requests\adapters.py", "Python", 0, 0, 0, -466, 0, -17, -102, -585
"c:\Users\edwar\OneDrive\Documents\Programming\Visual Studio 2022\PARTS_Web\app\env_test\Lib\site-packages\pip\_vendor\requests\api.py", "Python", 0, 0, 0, -117, 0, -3, -38, -158
"c:\Users\edwar\OneDrive\Documents\Programming\Visual Studio 2022\PARTS_Web\app\env_test\Lib\site-packages\pip\_vendor\requests\auth.py", "Python", 0, 0, 0, -223, 0, -27, -66, -316
"c:\Users\edwar\OneDrive\Documents\Programming\Visual Studio 2022\PARTS_Web\app\env_test\Lib\site-packages\pip\_vendor\requests\certs.py", "Python", 0, 0, 0, -17, 0, -1, -7, -25
"c:\Users\edwar\OneDrive\Documents\Programming\Visual Studio 2022\PARTS_Web\app\env_test\Lib\site-packages\pip\_vendor\requests\compat.py", "Python", 0, 0, 0, -44, 0, -12, -12, -68
"c:\Users\edwar\OneDrive\Documents\Programming\Visual Studio 2022\PARTS_Web\app\env_test\Lib\site-packages\pip\_vendor\requests\cookies.py", "Python", 0, 0, 0, -439, 0, -12, -111, -562
"c:\Users\edwar\OneDrive\Documents\Programming\Visual Studio 2022\PARTS_Web\app\env_test\Lib\site-packages\pip\_vendor\requests\exceptions.py", "Python", 0, 0, 0, -82, 0, -1, -59, -142
"c:\Users\edwar\OneDrive\Documents\Programming\Visual Studio 2022\PARTS_Web\app\env_test\Lib\site-packages\pip\_vendor\requests\help.py", "Python", 0, 0, 0, -109, 0, 0, -23, -132
"c:\Users\edwar\OneDrive\Documents\Programming\Visual Studio 2022\PARTS_Web\app\env_test\Lib\site-packages\pip\_vendor\requests\hooks.py", "Python", 0, 0, 0, -23, 0, -1, -10, -34
"c:\Users\edwar\OneDrive\Documents\Programming\Visual Studio 2022\PARTS_Web\app\env_test\Lib\site-packages\pip\_vendor\requests\models.py", "Python", 0, 0, 0, -737, 0, -114, -184, -1035
"c:\Users\edwar\OneDrive\Documents\Programming\Visual Studio 2022\PARTS_Web\app\env_test\Lib\site-packages\pip\_vendor\requests\packages.py", "Python", 0, 0, 0, -8, 0, -5, -4, -17
"c:\Users\edwar\OneDrive\Documents\Programming\Visual Studio 2022\PARTS_Web\app\env_test\Lib\site-packages\pip\_vendor\requests\sessions.py", "Python", 0, 0, 0, -564, 0, -114, -154, -832
"c:\Users\edwar\OneDrive\Documents\Programming\Visual Studio 2022\PARTS_Web\app\env_test\Lib\site-packages\pip\_vendor\requests\status_codes.py", "Python", 0, 0, 0, -112, 0, -4, -13, -129
"c:\Users\edwar\OneDrive\Documents\Programming\Visual Studio 2022\PARTS_Web\app\env_test\Lib\site-packages\pip\_vendor\requests\structures.py", "Python", 0, 0, 0, -67, 0, -5, -28, -100
"c:\Users\edwar\OneDrive\Documents\Programming\Visual Studio 2022\PARTS_Web\app\env_test\Lib\site-packages\pip\_vendor\requests\utils.py", "Python", 0, 0, 0, -766, 0, -86, -235, -1087
"c:\Users\edwar\OneDrive\Documents\Programming\Visual Studio 2022\PARTS_Web\app\env_test\Lib\site-packages\pip\_vendor\resolvelib\__init__.py", "Python", 0, 0, 0, -23, 0, 0, -4, -27
"c:\Users\edwar\OneDrive\Documents\Programming\Visual Studio 2022\PARTS_Web\app\env_test\Lib\site-packages\pip\_vendor\resolvelib\compat\__init__.py", "Python", 0, 0, 0, 0, 0, 0, -1, -1
"c:\Users\edwar\OneDrive\Documents\Programming\Visual Studio 2022\PARTS_Web\app\env_test\Lib\site-packages\pip\_vendor\resolvelib\compat\collections_abc.py", "Python", 0, 0, 0, -5, 0, 0, -2, -7
"c:\Users\edwar\OneDrive\Documents\Programming\Visual Studio 2022\PARTS_Web\app\env_test\Lib\site-packages\pip\_vendor\resolvelib\providers.py", "Python", 0, 0, 0, -105, 0, 0, -29, -134
"c:\Users\edwar\OneDrive\Documents\Programming\Visual Studio 2022\PARTS_Web\app\env_test\Lib\site-packages\pip\_vendor\resolvelib\reporters.py", "Python", 0, 0, 0, -31, 0, 0, -13, -44
"c:\Users\edwar\OneDrive\Documents\Programming\Visual Studio 2022\PARTS_Web\app\env_test\Lib\site-packages\pip\_vendor\resolvelib\resolvers.py", "Python", 0, 0, 0, -360, 0, -29, -94, -483
"c:\Users\edwar\OneDrive\Documents\Programming\Visual Studio 2022\PARTS_Web\app\env_test\Lib\site-packages\pip\_vendor\resolvelib\structs.py", "Python", 0, 0, 0, -122, 0, 0, -44, -166
"c:\Users\edwar\OneDrive\Documents\Programming\Visual Studio 2022\PARTS_Web\app\env_test\Lib\site-packages\pip\_vendor\rich\__init__.py", "Python", 0, 0, 0, -142, 0, -3, -33, -178
"c:\Users\edwar\OneDrive\Documents\Programming\Visual Studio 2022\PARTS_Web\app\env_test\Lib\site-packages\pip\_vendor\rich\__main__.py", "Python", 0, 0, 0, -234, 0, -2, -39, -275
"c:\Users\edwar\OneDrive\Documents\Programming\Visual Studio 2022\PARTS_Web\app\env_test\Lib\site-packages\pip\_vendor\rich\_cell_widths.py", "Python", 0, 0, 0, -449, 0, -1, -2, -452
"c:\Users\edwar\OneDrive\Documents\Programming\Visual Studio 2022\PARTS_Web\app\env_test\Lib\site-packages\pip\_vendor\rich\_emoji_codes.py", "Python", 0, 0, 0, -3610, 0, 0, -1, -3611
"c:\Users\edwar\OneDrive\Documents\Programming\Visual Studio 2022\PARTS_Web\app\env_test\Lib\site-packages\pip\_vendor\rich\_emoji_replace.py", "Python", 0, 0, 0, -25, 0, 0, -8, -33
"c:\Users\edwar\OneDrive\Documents\Programming\Visual Studio 2022\PARTS_Web\app\env_test\Lib\site-packages\pip\_vendor\rich\_export_format.py", "Python", 0, 0, 0, -70, 0, 0, -9, -79
"c:\Users\edwar\OneDrive\Documents\Programming\Visual Studio 2022\PARTS_Web\app\env_test\Lib\site-packages\pip\_vendor\rich\_extension.py", "Python", 0, 0, 0, -6, 0, -1, -4, -11
"c:\Users\edwar\OneDrive\Documents\Programming\Visual Studio 2022\PARTS_Web\app\env_test\Lib\site-packages\pip\_vendor\rich\_inspect.py", "Python", 0, 0, 0, -227, 0, -4, -40, -271
"c:\Users\edwar\OneDrive\Documents\Programming\Visual Studio 2022\PARTS_Web\app\env_test\Lib\site-packages\pip\_vendor\rich\_log_render.py", "Python", 0, 0, 0, -81, 0, 0, -14, -95
"c:\Users\edwar\OneDrive\Documents\Programming\Visual Studio 2022\PARTS_Web\app\env_test\Lib\site-packages\pip\_vendor\rich\_loop.py", "Python", 0, 0, 0, -36, 0, 0, -8, -44
"c:\Users\edwar\OneDrive\Documents\Programming\Visual Studio 2022\PARTS_Web\app\env_test\Lib\site-packages\pip\_vendor\rich\_null_file.py", "Python", 0, 0, 0, -55, 0, -1, -28, -84
"c:\Users\edwar\OneDrive\Documents\Programming\Visual Studio 2022\PARTS_Web\app\env_test\Lib\site-packages\pip\_vendor\rich\_palettes.py", "Python", 0, 0, 0, -301, 0, -3, -6, -310
"c:\Users\edwar\OneDrive\Documents\Programming\Visual Studio 2022\PARTS_Web\app\env_test\Lib\site-packages\pip\_vendor\rich\_pick.py", "Python", 0, 0, 0, -13, 0, 0, -5, -18
"c:\Users\edwar\OneDrive\Documents\Programming\Visual Studio 2022\PARTS_Web\app\env_test\Lib\site-packages\pip\_vendor\rich\_ratio.py", "Python", 0, 0, 0, -122, 0, -12, -27, -161
"c:\Users\edwar\OneDrive\Documents\Programming\Visual Studio 2022\PARTS_Web\app\env_test\Lib\site-packages\pip\_vendor\rich\_spinners.py", "Python", 0, 0, 0, -481, 0, 0, -2, -483
"c:\Users\edwar\OneDrive\Documents\Programming\Visual Studio 2022\PARTS_Web\app\env_test\Lib\site-packages\pip\_vendor\rich\_stack.py", "Python", 0, 0, 0, -11, 0, 0, -6, -17
"c:\Users\edwar\OneDrive\Documents\Programming\Visual Studio 2022\PARTS_Web\app\env_test\Lib\site-packages\pip\_vendor\rich\_timer.py", "Python", 0, 0, 0, -14, 0, 0, -6, -20
"c:\Users\edwar\OneDrive\Documents\Programming\Visual Studio 2022\PARTS_Web\app\env_test\Lib\site-packages\pip\_vendor\rich\_win32_console.py", "Python", 0, 0, 0, -527, 0, -4, -132, -663
"c:\Users\edwar\OneDrive\Documents\Programming\Visual Studio 2022\PARTS_Web\app\env_test\Lib\site-packages\pip\_vendor\rich\_windows.py", "Python", 0, 0, 0, -55, 0, -1, -17, -73
"c:\Users\edwar\OneDrive\Documents\Programming\Visual Studio 2022\PARTS_Web\app\env_test\Lib\site-packages\pip\_vendor\rich\_windows_renderer.py", "Python", 0, 0, 0, -52, 0, 0, -5, -57
"c:\Users\edwar\OneDrive\Documents\Programming\Visual Studio 2022\PARTS_Web\app\env_test\Lib\site-packages\pip\_vendor\rich\_wrap.py", "Python", 0, 0, 0, -46, 0, 0, -11, -57
"c:\Users\edwar\OneDrive\Documents\Programming\Visual Studio 2022\PARTS_Web\app\env_test\Lib\site-packages\pip\_vendor\rich\abc.py", "Python", 0, 0, 0, -22, 0, 0, -12, -34
"c:\Users\edwar\OneDrive\Documents\Programming\Visual Studio 2022\PARTS_Web\app\env_test\Lib\site-packages\pip\_vendor\rich\align.py", "Python", 0, 0, 0, -270, 0, -4, -38, -312
"c:\Users\edwar\OneDrive\Documents\Programming\Visual Studio 2022\PARTS_Web\app\env_test\Lib\site-packages\pip\_vendor\rich\ansi.py", "Python", 0, 0, 0, -198, 0, -6, -34, -238
"c:\Users\edwar\OneDrive\Documents\Programming\Visual Studio 2022\PARTS_Web\app\env_test\Lib\site-packages\pip\_vendor\rich\bar.py", "Python", 0, 0, 0, -71, 0, -5, -19, -95
"c:\Users\edwar\OneDrive\Documents\Programming\Visual Studio 2022\PARTS_Web\app\env_test\Lib\site-packages\pip\_vendor\rich\box.py", "Python", 0, 0, 0, -418, 0, -11, -89, -518
"c:\Users\edwar\OneDrive\Documents\Programming\Visual Studio 2022\PARTS_Web\app\env_test\Lib\site-packages\pip\_vendor\rich\cells.py", "Python", 0, 0, 0, -117, 0, -4, -34, -155
"c:\Users\edwar\OneDrive\Documents\Programming\Visual Studio 2022\PARTS_Web\app\env_test\Lib\site-packages\pip\_vendor\rich\color.py", "Python", 0, 0, 0, -541, 0, -3, -75, -619
"c:\Users\edwar\OneDrive\Documents\Programming\Visual Studio 2022\PARTS_Web\app\env_test\Lib\site-packages\pip\_vendor\rich\color_triplet.py", "Python", 0, 0, 0, -30, 0, 0, -9, -39
"c:\Users\edwar\OneDrive\Documents\Programming\Visual Studio 2022\PARTS_Web\app\env_test\Lib\site-packages\pip\_vendor\rich\columns.py", "Python", 0, 0, 0, -166, 0, -1, -21, -188
"c:\Users\edwar\OneDrive\Documents\Programming\Visual Studio 2022\PARTS_Web\app\env_test\Lib\site-packages\pip\_vendor\rich\console.py", "Python", 0, 0, 0, -2228, 0, -15, -370, -2613
"c:\Users\edwar\OneDrive\Documents\Programming\Visual Studio 2022\PARTS_Web\app\env_test\Lib\site-packages\pip\_vendor\rich\constrain.py", "Python", 0, 0, 0, -29, 0, 0, -9, -38
"c:\Users\edwar\OneDrive\Documents\Programming\Visual Studio 2022\PARTS_Web\app\env_test\Lib\site-packages\pip\_vendor\rich\containers.py", "Python", 0, 0, 0, -139, 0, 0, -29, -168
"c:\Users\edwar\OneDrive\Documents\Programming\Visual Studio 2022\PARTS_Web\app\env_test\Lib\site-packages\pip\_vendor\rich\control.py", "Python", 0, 0, 0, -180, 0, -1, -45, -226
"c:\Users\edwar\OneDrive\Documents\Programming\Visual Studio 2022\PARTS_Web\app\env_test\Lib\site-packages\pip\_vendor\rich\default_styles.py", "Python", 0, 0, 0, -179, 0, 0, -10, -189
"c:\Users\edwar\OneDrive\Documents\Programming\Visual Studio 2022\PARTS_Web\app\env_test\Lib\site-packages\pip\_vendor\rich\diagnose.py", "Python", 0, 0, 0, -30, 0, 0, -8, -38
"c:\Users\edwar\OneDrive\Documents\Programming\Visual Studio 2022\PARTS_Web\app\env_test\Lib\site-packages\pip\_vendor\rich\emoji.py", "Python", 0, 0, 0, -70, 0, 0, -27, -97
"c:\Users\edwar\OneDrive\Documents\Programming\Visual Studio 2022\PARTS_Web\app\env_test\Lib\site-packages\pip\_vendor\rich\errors.py", "Python", 0, 0, 0, -18, 0, 0, -17, -35
"c:\Users\edwar\OneDrive\Documents\Programming\Visual Studio 2022\PARTS_Web\app\env_test\Lib\site-packages\pip\_vendor\rich\file_proxy.py", "Python", 0, 0, 0, -45, 0, 0, -10, -55
"c:\Users\edwar\OneDrive\Documents\Programming\Visual Studio 2022\PARTS_Web\app\env_test\Lib\site-packages\pip\_vendor\rich\filesize.py", "Python", 0, 0, 0, -70, 0, -1, -19, -90
"c:\Users\edwar\OneDrive\Documents\Programming\Visual Studio 2022\PARTS_Web\app\env_test\Lib\site-packages\pip\_vendor\rich\highlighter.py", "Python", 0, 0, 0, -151, 0, -37, -45, -233
"c:\Users\edwar\OneDrive\Documents\Programming\Visual Studio 2022\PARTS_Web\app\env_test\Lib\site-packages\pip\_vendor\rich\json.py", "Python", 0, 0, 0, -123, 0, 0, -18, -141
"c:\Users\edwar\OneDrive\Documents\Programming\Visual Studio 2022\PARTS_Web\app\env_test\Lib\site-packages\pip\_vendor\rich\jupyter.py", "Python", 0, 0, 0, -77, 0, -2, -23, -102
"c:\Users\edwar\OneDrive\Documents\Programming\Visual Studio 2022\PARTS_Web\app\env_test\Lib\site-packages\pip\_vendor\rich\layout.py", "Python", 0, 0, 0, -358, 0, 0, -86, -444
"c:\Users\edwar\OneDrive\Documents\Programming\Visual Studio 2022\PARTS_Web\app\env_test\Lib\site-packages\pip\_vendor\rich\live.py", "Python", 0, 0, 0, -319, 0, -6, -49, -374
"c:\Users\edwar\OneDrive\Documents\Programming\Visual Studio 2022\PARTS_Web\app\env_test\Lib\site-packages\pip\_vendor\rich\live_render.py", "Python", 0, 0, 0, -95, 0, 0, -19, -114
"c:\Users\edwar\OneDrive\Documents\Programming\Visual Studio 2022\PARTS_Web\app\env_test\Lib\site-packages\pip\_vendor\rich\logging.py", "Python", 0, 0, 0, -253, 0, -4, -33, -290
"c:\Users\edwar\OneDrive\Documents\Programming\Visual Studio 2022\PARTS_Web\app\env_test\Lib\site-packages\pip\_vendor\rich\markup.py", "Python", 0, 0, 0, -197, 0, -3, -47, -247
"c:\Users\edwar\OneDrive\Documents\Programming\Visual Studio 2022\PARTS_Web\app\env_test\Lib\site-packages\pip\_vendor\rich\measure.py", "Python", 0, 0, 0, -126, 0, 0, -26, -152
"c:\Users\edwar\OneDrive\Documents\Programming\Visual Studio 2022\PARTS_Web\app\env_test\Lib\site-packages\pip\_vendor\rich\padding.py", "Python", 0, 0, 0, -121, 0, 0, -21, -142
"c:\Users\edwar\OneDrive\Documents\Programming\Visual Studio 2022\PARTS_Web\app\env_test\Lib\site-packages\pip\_vendor\rich\pager.py", "Python", 0, 0, 0, -23, 0, 0, -12, -35
"c:\Users\edwar\OneDrive\Documents\Programming\Visual Studio 2022\PARTS_Web\app\env_test\Lib\site-packages\pip\_vendor\rich\palette.py", "Python", 0, 0, 0, -82, 0, -1, -18, -101
"c:\Users\edwar\OneDrive\Documents\Programming\Visual Studio 2022\PARTS_Web\app\env_test\Lib\site-packages\pip\_vendor\rich\panel.py", "Python", 0, 0, 0, -277, 0, 0, -32, -309
"c:\Users\edwar\OneDrive\Documents\Programming\Visual Studio 2022\PARTS_Web\app\env_test\Lib\site-packages\pip\_vendor\rich\pretty.py", "Python", 0, 0, 0, -884, 0, -24, -122, -1030
"c:\Users\edwar\OneDrive\Documents\Programming\Visual Studio 2022\PARTS_Web\app\env_test\Lib\site-packages\pip\_vendor\rich\progress.py", "Python", 0, 0, 0, -1438, 0, -10, -260, -1708
"c:\Users\edwar\OneDrive\Documents\Programming\Visual Studio 2022\PARTS_Web\app\env_test\Lib\site-packages\pip\_vendor\rich\progress_bar.py", "Python", 0, 0, 0, -193, 0, -1, -31, -225
"c:\Users\edwar\OneDrive\Documents\Programming\Visual Studio 2022\PARTS_Web\app\env_test\Lib\site-packages\pip\_vendor\rich\prompt.py", "Python", 0, 0, 0, -295, 0, 0, -82, -377
"c:\Users\edwar\OneDrive\Documents\Programming\Visual Studio 2022\PARTS_Web\app\env_test\Lib\site-packages\pip\_vendor\rich\protocol.py", "Python", 0, 0, 0, -31, 0, -1, -11, -43
"c:\Users\edwar\OneDrive\Documents\Programming\Visual Studio 2022\PARTS_Web\app\env_test\Lib\site-packages\pip\_vendor\rich\region.py", "Python", 0, 0, 0, -7, 0, 0, -4, -11
"c:\Users\edwar\OneDrive\Documents\Programming\Visual Studio 2022\PARTS_Web\app\env_test\Lib\site-packages\pip\_vendor\rich\repr.py", "Python", 0, 0, 0, -116, 0, 0, -34, -150
"c:\Users\edwar\OneDrive\Documents\Programming\Visual Studio 2022\PARTS_Web\app\env_test\Lib\site-packages\pip\_vendor\rich\rule.py", "Python", 0, 0, 0, -112, 0, -1, -22, -135
"c:\Users\edwar\OneDrive\Documents\Programming\Visual Studio 2022\PARTS_Web\app\env_test\Lib\site-packages\pip\_vendor\rich\scope.py", "Python", 0, 0, 0, -73, 0, 0, -14, -87
"c:\Users\edwar\OneDrive\Documents\Programming\Visual Studio 2022\PARTS_Web\app\env_test\Lib\site-packages\pip\_vendor\rich\screen.py", "Python", 0, 0, 0, -44, 0, 0, -11, -55
"c:\Users\edwar\OneDrive\Documents\Programming\Visual Studio 2022\PARTS_Web\app\env_test\Lib\site-packages\pip\_vendor\rich\segment.py", "Python", 0, 0, 0, -624, 0, -1, -115, -740
"c:\Users\edwar\OneDrive\Documents\Programming\Visual Studio 2022\PARTS_Web\app\env_test\Lib\site-packages\pip\_vendor\rich\spinner.py", "Python", 0, 0, 0, -115, 0, 0, -22, -137
"c:\Users\edwar\OneDrive\Documents\Programming\Visual Studio 2022\PARTS_Web\app\env_test\Lib\site-packages\pip\_vendor\rich\status.py", "Python", 0, 0, 0, -113, 0, 0, -20, -133
"c:\Users\edwar\OneDrive\Documents\Programming\Visual Studio 2022\PARTS_Web\app\env_test\Lib\site-packages\pip\_vendor\rich\style.py", "Python", 0, 0, 0, -675, 0, -2, -97, -774
"c:\Users\edwar\OneDrive\Documents\Programming\Visual Studio 2022\PARTS_Web\app\env_test\Lib\site-packages\pip\_vendor\rich\styled.py", "Python", 0, 0, 0, -31, 0, 0, -12, -43
"c:\Users\edwar\OneDrive\Documents\Programming\Visual Studio 2022\PARTS_Web\app\env_test\Lib\site-packages\pip\_vendor\rich\syntax.py", "Python", 0, 0, 0, -826, 0, -13, -107, -946
"c:\Users\edwar\OneDrive\Documents\Programming\Visual Studio 2022\PARTS_Web\app\env_test\Lib\site-packages\pip\_vendor\rich\table.py", "Python", 0, 0, 0, -878, 0, -4, -121, -1003
"c:\Users\edwar\OneDrive\Documents\Programming\Visual Studio 2022\PARTS_Web\app\env_test\Lib\site-packages\pip\_vendor\rich\terminal_theme.py", "Python", 0, 0, 0, -143, 0, 0, -11, -154
"c:\Users\edwar\OneDrive\Documents\Programming\Visual Studio 2022\PARTS_Web\app\env_test\Lib\site-packages\pip\_vendor\rich\text.py", "Python", 0, 0, 0, -1121, 0, -5, -186, -1312
"c:\Users\edwar\OneDrive\Documents\Programming\Visual Studio 2022\PARTS_Web\app\env_test\Lib\site-packages\pip\_vendor\rich\theme.py", "Python", 0, 0, 0, -88, 0, 0, -25, -113
"c:\Users\edwar\OneDrive\Documents\Programming\Visual Studio 2022\PARTS_Web\app\env_test\Lib\site-packages\pip\_vendor\rich\themes.py", "Python", 0, 0, 0, -3, 0, 0, -3, -6
"c:\Users\edwar\OneDrive\Documents\Programming\Visual Studio 2022\PARTS_Web\app\env_test\Lib\site-packages\pip\_vendor\rich\traceback.py", "Python", 0, 0, 0, -583, 0, -14, -81, -678
"c:\Users\edwar\OneDrive\Documents\Programming\Visual Studio 2022\PARTS_Web\app\env_test\Lib\site-packages\pip\_vendor\rich\tree.py", "Python", 0, 0, 0, -215, 0, -1, -36, -252
"c:\Users\edwar\OneDrive\Documents\Programming\Visual Studio 2022\PARTS_Web\app\env_test\Lib\site-packages\pip\_vendor\six.py", "Python", 0, 0, 0, -755, 0, -53, -191, -999
"c:\Users\edwar\OneDrive\Documents\Programming\Visual Studio 2022\PARTS_Web\app\env_test\Lib\site-packages\pip\_vendor\tenacity\__init__.py", "Python", 0, 0, 0, -377, 0, -41, -102, -520
"c:\Users\edwar\OneDrive\Documents\Programming\Visual Studio 2022\PARTS_Web\app\env_test\Lib\site-packages\pip\_vendor\tenacity\_asyncio.py", "Python", 0, 0, 0, -61, 0, -18, -14, -93
"c:\Users\edwar\OneDrive\Documents\Programming\Visual Studio 2022\PARTS_Web\app\env_test\Lib\site-packages\pip\_vendor\tenacity\_utils.py", "Python", 0, 0, 0, -39, 0, -19, -11, -69
"c:\Users\edwar\OneDrive\Documents\Programming\Visual Studio 2022\PARTS_Web\app\env_test\Lib\site-packages\pip\_vendor\tenacity\after.py", "Python", 0, 0, 0, -21, 0, -15, -11, -47
"c:\Users\edwar\OneDrive\Documents\Programming\Visual Studio 2022\PARTS_Web\app\env_test\Lib\site-packages\pip\_vendor\tenacity\before.py", "Python", 0, 0, 0, -16, 0, -15, -11, -42
"c:\Users\edwar\OneDrive\Documents\Programming\Visual Studio 2022\PARTS_Web\app\env_test\Lib\site-packages\pip\_vendor\tenacity\before_sleep.py", "Python", 0, 0, 0, -31, 0, -15, -13, -59
"c:\Users\edwar\OneDrive\Documents\Programming\Visual Studio 2022\PARTS_Web\app\env_test\Lib\site-packages\pip\_vendor\tenacity\nap.py", "Python", 0, 0, 0, -16, 0, -18, -10, -44
"c:\Users\edwar\OneDrive\Documents\Programming\Visual Studio 2022\PARTS_Web\app\env_test\Lib\site-packages\pip\_vendor\tenacity\retry.py", "Python", 0, 0, 0, -156, 0, -18, -67, -241
"c:\Users\edwar\OneDrive\Documents\Programming\Visual Studio 2022\PARTS_Web\app\env_test\Lib\site-packages\pip\_vendor\tenacity\stop.py", "Python", 0, 0, 0, -49, 0, -15, -33, -97
"c:\Users\edwar\OneDrive\Documents\Programming\Visual Studio 2022\PARTS_Web\app\env_test\Lib\site-packages\pip\_vendor\tenacity\tornadoweb.py", "Python", 0, 0, 0, -37, 0, -13, -10, -60
"c:\Users\edwar\OneDrive\Documents\Programming\Visual Studio 2022\PARTS_Web\app\env_test\Lib\site-packages\pip\_vendor\tenacity\wait.py", "Python", 0, 0, 0, -155, 0, -16, -62, -233
"c:\Users\edwar\OneDrive\Documents\Programming\Visual Studio 2022\PARTS_Web\app\env_test\Lib\site-packages\pip\_vendor\tomli\__init__.py", "Python", 0, 0, 0, -4, 0, -4, -4, -12
"c:\Users\edwar\OneDrive\Documents\Programming\Visual Studio 2022\PARTS_Web\app\env_test\Lib\site-packages\pip\_vendor\tomli\_parser.py", "Python", 0, 0, 0, -534, 0, -46, -112, -692
"c:\Users\edwar\OneDrive\Documents\Programming\Visual Studio 2022\PARTS_Web\app\env_test\Lib\site-packages\pip\_vendor\tomli\_re.py", "Python", 0, 0, 0, -87, 0, -6, -15, -108
"c:\Users\edwar\OneDrive\Documents\Programming\Visual Studio 2022\PARTS_Web\app\env_test\Lib\site-packages\pip\_vendor\tomli\_types.py", "Python", 0, 0, 0, -4, 0, -4, -3, -11
"c:\Users\edwar\OneDrive\Documents\Programming\Visual Studio 2022\PARTS_Web\app\env_test\Lib\site-packages\pip\_vendor\typing_extensions.py", "Python", 0, 0, 0, -1629, 0, -145, -436, -2210
"c:\Users\edwar\OneDrive\Documents\Programming\Visual Studio 2022\PARTS_Web\app\env_test\Lib\site-packages\pip\_vendor\urllib3\__init__.py", "Python", 0, 0, 0, -72, 0, -15, -16, -103
"c:\Users\edwar\OneDrive\Documents\Programming\Visual Studio 2022\PARTS_Web\app\env_test\Lib\site-packages\pip\_vendor\urllib3\_collections.py", "Python", 0, 0, 0, -252, 0, -19, -67, -338
"c:\Users\edwar\OneDrive\Documents\Programming\Visual Studio 2022\PARTS_Web\app\env_test\Lib\site-packages\pip\_vendor\urllib3\_version.py", "Python", 0, 0, 0, -1, 0, -1, -1, -3
"c:\Users\edwar\OneDrive\Documents\Programming\Visual Studio 2022\PARTS_Web\app\env_test\Lib\site-packages\pip\_vendor\urllib3\connection.py", "Python", 0, 0, 0, -420, 0, -52, -96, -568
"c:\Users\edwar\OneDrive\Documents\Programming\Visual Studio 2022\PARTS_Web\app\env_test\Lib\site-packages\pip\_vendor\urllib3\connectionpool.py", "Python", 0, 0, 0, -825, 0, -108, -178, -1111
"c:\Users\edwar\OneDrive\Documents\Programming\Visual Studio 2022\PARTS_Web\app\env_test\Lib\site-packages\pip\_vendor\urllib3\contrib\__init__.py", "Python", 0, 0, 0, 0, 0, 0, -1, -1
"c:\Users\edwar\OneDrive\Documents\Programming\Visual Studio 2022\PARTS_Web\app\env_test\Lib\site-packages\pip\_vendor\urllib3\contrib\_appengine_environ.py", "Python", 0, 0, 0, -24, 0, 0, -13, -37
"c:\Users\edwar\OneDrive\Documents\Programming\Visual Studio 2022\PARTS_Web\app\env_test\Lib\site-packages\pip\_vendor\urllib3\contrib\_securetransport\__init__.py", "Python", 0, 0, 0, 0, 0, 0, -1, -1
"c:\Users\edwar\OneDrive\Documents\Programming\Visual Studio 2022\PARTS_Web\app\env_test\Lib\site-packages\pip\_vendor\urllib3\contrib\_securetransport\bindings.py", "Python", 0, 0, 0, -414, 0, -9, -97, -520
"c:\Users\edwar\OneDrive\Documents\Programming\Visual Studio 2022\PARTS_Web\app\env_test\Lib\site-packages\pip\_vendor\urllib3\contrib\_securetransport\low_level.py", "Python", 0, 0, 0, -285, 0, -51, -62, -398
"c:\Users\edwar\OneDrive\Documents\Programming\Visual Studio 2022\PARTS_Web\app\env_test\Lib\site-packages\pip\_vendor\urllib3\contrib\appengine.py", "Python", 0, 0, 0, -244, 0, -14, -57, -315
"c:\Users\edwar\OneDrive\Documents\Programming\Visual Studio 2022\PARTS_Web\app\env_test\Lib\site-packages\pip\_vendor\urllib3\contrib\ntlmpool.py", "Python", 0, 0, 0, -104, 0, -7, -20, -131
"c:\Users\edwar\OneDrive\Documents\Programming\Visual Studio 2022\PARTS_Web\app\env_test\Lib\site-packages\pip\_vendor\urllib3\contrib\pyopenssl.py", "Python", 0, 0, 0, -389, 0, -25, -105, -519
"c:\Users\edwar\OneDrive\Documents\Programming\Visual Studio 2022\PARTS_Web\app\env_test\Lib\site-packages\pip\_vendor\urllib3\contrib\securetransport.py", "Python", 0, 0, 0, -646, 0, -134, -142, -922
"c:\Users\edwar\OneDrive\Documents\Programming\Visual Studio 2022\PARTS_Web\app\env_test\Lib\site-packages\pip\_vendor\urllib3\contrib\socks.py", "Python", 0, 0, 0, -167, 0, -7, -43, -217
"c:\Users\edwar\OneDrive\Documents\Programming\Visual Studio 2022\PARTS_Web\app\env_test\Lib\site-packages\pip\_vendor\urllib3\exceptions.py", "Python", 0, 0, 0, -183, 0, -10, -131, -324
"c:\Users\edwar\OneDrive\Documents\Programming\Visual Studio 2022\PARTS_Web\app\env_test\Lib\site-packages\pip\_vendor\urllib3\fields.py", "Python", 0, 0, 0, -212, 0, -5, -58, -275
"c:\Users\edwar\OneDrive\Documents\Programming\Visual Studio 2022\PARTS_Web\app\env_test\Lib\site-packages\pip\_vendor\urllib3\filepost.py", "Python", 0, 0, 0, -70, 0, 0, -29, -99
"c:\Users\edwar\OneDrive\Documents\Programming\Visual Studio 2022\PARTS_Web\app\env_test\Lib\site-packages\pip\_vendor\urllib3\packages\__init__.py", "Python", 0, 0, 0, 0, 0, 0, -1, -1
"c:\Users\edwar\OneDrive\Documents\Programming\Visual Studio 2022\PARTS_Web\app\env_test\Lib\site-packages\pip\_vendor\urllib3\packages\backports\__init__.py", "Python", 0, 0, 0, 0, 0, 0, -1, -1
"c:\Users\edwar\OneDrive\Documents\Programming\Visual Studio 2022\PARTS_Web\app\env_test\Lib\site-packages\pip\_vendor\urllib3\packages\backports\makefile.py", "Python", 0, 0, 0, -47, 0, -1, -4, -52
"c:\Users\edwar\OneDrive\Documents\Programming\Visual Studio 2022\PARTS_Web\app\env_test\Lib\site-packages\pip\_vendor\urllib3\packages\six.py", "Python", 0, 0, 0, -805, 0, -53, -219, -1077
"c:\Users\edwar\OneDrive\Documents\Programming\Visual Studio 2022\PARTS_Web\app\env_test\Lib\site-packages\pip\_vendor\urllib3\poolmanager.py", "Python", 0, 0, 0, -402, 0, -33, -103, -538
"c:\Users\edwar\OneDrive\Documents\Programming\Visual Studio 2022\PARTS_Web\app\env_test\Lib\site-packages\pip\_vendor\urllib3\request.py", "Python", 0, 0, 0, -135, 0, 0, -36, -171
"c:\Users\edwar\OneDrive\Documents\Programming\Visual Studio 2022\PARTS_Web\app\env_test\Lib\site-packages\pip\_vendor\urllib3\response.py", "Python", 0, 0, 0, -669, 0, -79, -132, -880
"c:\Users\edwar\OneDrive\Documents\Programming\Visual Studio 2022\PARTS_Web\app\env_test\Lib\site-packages\pip\_vendor\urllib3\util\__init__.py", "Python", 0, 0, 0, -46, 0, -1, -3, -50
"c:\Users\edwar\OneDrive\Documents\Programming\Visual Studio 2022\PARTS_Web\app\env_test\Lib\site-packages\pip\_vendor\urllib3\util\connection.py", "Python", 0, 0, 0, -100, 0, -18, -32, -150
"c:\Users\edwar\OneDrive\Documents\Programming\Visual Studio 2022\PARTS_Web\app\env_test\Lib\site-packages\pip\_vendor\urllib3\util\proxy.py", "Python", 0, 0, 0, -43, 0, -4, -11, -58
"c:\Users\edwar\OneDrive\Documents\Programming\Visual Studio 2022\PARTS_Web\app\env_test\Lib\site-packages\pip\_vendor\urllib3\util\queue.py", "Python", 0, 0, 0, -14, 0, -1, -8, -23
"c:\Users\edwar\OneDrive\Documents\Programming\Visual Studio 2022\PARTS_Web\app\env_test\Lib\site-packages\pip\_vendor\urllib3\util\request.py", "Python", 0, 0, 0, -103, 0, -6, -29, -138
"c:\Users\edwar\OneDrive\Documents\Programming\Visual Studio 2022\PARTS_Web\app\env_test\Lib\site-packages\pip\_vendor\urllib3\util\response.py", "Python", 0, 0, 0, -64, 0, -20, -24, -108
"c:\Users\edwar\OneDrive\Documents\Programming\Visual Studio 2022\PARTS_Web\app\env_test\Lib\site-packages\pip\_vendor\urllib3\util\retry.py", "Python", 0, 0, 0, -469, 0, -29, -123, -621
"c:\Users\edwar\OneDrive\Documents\Programming\Visual Studio 2022\PARTS_Web\app\env_test\Lib\site-packages\pip\_vendor\urllib3\util\ssl_.py", "Python", 0, 0, 0, -352, 0, -59, -85, -496
"c:\Users\edwar\OneDrive\Documents\Programming\Visual Studio 2022\PARTS_Web\app\env_test\Lib\site-packages\pip\_vendor\urllib3\util\ssl_match_hostname.py", "Python", 0, 0, 0, -99, 0, -37, -24, -160
"c:\Users\edwar\OneDrive\Documents\Programming\Visual Studio 2022\PARTS_Web\app\env_test\Lib\site-packages\pip\_vendor\urllib3\util\ssltransport.py", "Python", 0, 0, 0, -178, 0, -2, -42, -222
"c:\Users\edwar\OneDrive\Documents\Programming\Visual Studio 2022\PARTS_Web\app\env_test\Lib\site-packages\pip\_vendor\urllib3\util\timeout.py", "Python", 0, 0, 0, -197, 0, -12, -60, -269
"c:\Users\edwar\OneDrive\Documents\Programming\Visual Studio 2022\PARTS_Web\app\env_test\Lib\site-packages\pip\_vendor\urllib3\util\url.py", "Python", 0, 0, 0, -320, 0, -37, -79, -436
"c:\Users\edwar\OneDrive\Documents\Programming\Visual Studio 2022\PARTS_Web\app\env_test\Lib\site-packages\pip\_vendor\urllib3\util\wait.py", "Python", 0, 0, 0, -89, 0, -38, -26, -153
"c:\Users\edwar\OneDrive\Documents\Programming\Visual Studio 2022\PARTS_Web\app\env_test\Lib\site-packages\pip\_vendor\webencodings\__init__.py", "Python", 0, 0, 0, -249, 0, -14, -80, -343
"c:\Users\edwar\OneDrive\Documents\Programming\Visual Studio 2022\PARTS_Web\app\env_test\Lib\site-packages\pip\_vendor\webencodings\labels.py", "Python", 0, 0, 0, -223, 0, -2, -7, -232
"c:\Users\edwar\OneDrive\Documents\Programming\Visual Studio 2022\PARTS_Web\app\env_test\Lib\site-packages\pip\_vendor\webencodings\mklabels.py", "Python", 0, 0, 0, -40, 0, -2, -18, -60
"c:\Users\edwar\OneDrive\Documents\Programming\Visual Studio 2022\PARTS_Web\app\env_test\Lib\site-packages\pip\_vendor\webencodings\tests.py", "Python", 0, 0, 0, -123, 0, -2, -29, -154
"c:\Users\edwar\OneDrive\Documents\Programming\Visual Studio 2022\PARTS_Web\app\env_test\Lib\site-packages\pip\_vendor\webencodings\x_user_defined.py", "Python", 0, 0, 0, -292, 0, -7, -27, -326
"c:\Users\edwar\OneDrive\Documents\Programming\Visual Studio 2022\PARTS_Web\app\env_test\Lib\site-packages\pkg_resources\__init__.py", "Python", 0, 0, 0, -2468, 0, -167, -654, -3289
"c:\Users\edwar\OneDrive\Documents\Programming\Visual Studio 2022\PARTS_Web\app\env_test\Lib\site-packages\pkg_resources\_vendor\__init__.py", "Python", 0, 0, 0, 0, 0, 0, -1, -1
"c:\Users\edwar\OneDrive\Documents\Programming\Visual Studio 2022\PARTS_Web\app\env_test\Lib\site-packages\pkg_resources\_vendor\appdirs.py", "Python", 0, 0, 0, -493, 0, -27, -89, -609
"c:\Users\edwar\OneDrive\Documents\Programming\Visual Studio 2022\PARTS_Web\app\env_test\Lib\site-packages\pkg_resources\_vendor\packaging\__about__.py", "Python", 0, 0, 0, -19, 0, -3, -6, -28
"c:\Users\edwar\OneDrive\Documents\Programming\Visual Studio 2022\PARTS_Web\app\env_test\Lib\site-packages\pkg_resources\_vendor\packaging\__init__.py", "Python", 0, 0, 0, -21, 0, -3, -3, -27
"c:\Users\edwar\OneDrive\Documents\Programming\Visual Studio 2022\PARTS_Web\app\env_test\Lib\site-packages\pkg_resources\_vendor\packaging\_compat.py", "Python", 0, 0, 0, -19, 0, -9, -11, -39
"c:\Users\edwar\OneDrive\Documents\Programming\Visual Studio 2022\PARTS_Web\app\env_test\Lib\site-packages\pkg_resources\_vendor\packaging\_structures.py", "Python", 0, 0, 0, -41, 0, -21, -25, -87
"c:\Users\edwar\OneDrive\Documents\Programming\Visual Studio 2022\PARTS_Web\app\env_test\Lib\site-packages\pkg_resources\_vendor\packaging\_typing.py", "Python", 0, 0, 0, -29, 0, -8, -12, -49
"c:\Users\edwar\OneDrive\Documents\Programming\Visual Studio 2022\PARTS_Web\app\env_test\Lib\site-packages\pkg_resources\_vendor\packaging\markers.py", "Python", 0, 0, 0, -224, 0, -28, -77, -329
"c:\Users\edwar\OneDrive\Documents\Programming\Visual Studio 2022\PARTS_Web\app\env_test\Lib\site-packages\pkg_resources\_vendor\packaging\requirements.py", "Python", 0, 0, 0, -100, 0, -12, -34, -146
"c:\Users\edwar\OneDrive\Documents\Programming\Visual Studio 2022\PARTS_Web\app\env_test\Lib\site-packages\pkg_resources\_vendor\packaging\specifiers.py", "Python", 0, 0, 0, -490, 0, -216, -158, -864
"c:\Users\edwar\OneDrive\Documents\Programming\Visual Studio 2022\PARTS_Web\app\env_test\Lib\site-packages\pkg_resources\_vendor\packaging\tags.py", "Python", 0, 0, 0, -543, 0, -88, -121, -752
"c:\Users\edwar\OneDrive\Documents\Programming\Visual Studio 2022\PARTS_Web\app\env_test\Lib\site-packages\pkg_resources\_vendor\packaging\utils.py", "Python", 0, 0, 0, -33, 0, -14, -19, -66
"c:\Users\edwar\OneDrive\Documents\Programming\Visual Studio 2022\PARTS_Web\app\env_test\Lib\site-packages\pkg_resources\_vendor\packaging\version.py", "Python", 0, 0, 0, -325, 0, -100, -111, -536
"c:\Users\edwar\OneDrive\Documents\Programming\Visual Studio 2022\PARTS_Web\app\env_test\Lib\site-packages\pkg_resources\_vendor\pyparsing.py", "Python", 0, 0, 0, -4648, 0, -255, -840, -5743
"c:\Users\edwar\OneDrive\Documents\Programming\Visual Studio 2022\PARTS_Web\app\env_test\Lib\site-packages\pkg_resources\extern\__init__.py", "Python", 0, 0, 0, -61, 0, 0, -13, -74
"c:\Users\edwar\OneDrive\Documents\Programming\Visual Studio 2022\PARTS_Web\app\env_test\Lib\site-packages\pkg_resources\tests\data\my-test-package-source\setup.py", "Python", 0, 0, 0, -6, 0, 0, -1, -7
"c:\Users\edwar\OneDrive\Documents\Programming\Visual Studio 2022\PARTS_Web\app\env_test\Lib\site-packages\setuptools\__init__.py", "Python", 0, 0, 0, -174, 0, -13, -55, -242
"c:\Users\edwar\OneDrive\Documents\Programming\Visual Studio 2022\PARTS_Web\app\env_test\Lib\site-packages\setuptools\_deprecation_warning.py", "Python", 0, 0, 0, -6, 0, 0, -2, -8
"c:\Users\edwar\OneDrive\Documents\Programming\Visual Studio 2022\PARTS_Web\app\env_test\Lib\site-packages\setuptools\_distutils\__init__.py", "Python", 0, 0, 0, -9, 0, 0, -7, -16
"c:\Users\edwar\OneDrive\Documents\Programming\Visual Studio 2022\PARTS_Web\app\env_test\Lib\site-packages\setuptools\_distutils\_msvccompiler.py", "Python", 0, 0, 0, -414, 0, -60, -88, -562
"c:\Users\edwar\OneDrive\Documents\Programming\Visual Studio 2022\PARTS_Web\app\env_test\Lib\site-packages\setuptools\_distutils\archive_util.py", "Python", 0, 0, 0, -202, 0, -8, -47, -257
"c:\Users\edwar\OneDrive\Documents\Programming\Visual Studio 2022\PARTS_Web\app\env_test\Lib\site-packages\setuptools\_distutils\bcppcompiler.py", "Python", 0, 0, 0, -248, 0, -78, -68, -394
"c:\Users\edwar\OneDrive\Documents\Programming\Visual Studio 2022\PARTS_Web\app\env_test\Lib\site-packages\setuptools\_distutils\ccompiler.py", "Python", 0, 0, 0, -799, 0, -156, -162, -1117
"c:\Users\edwar\OneDrive\Documents\Programming\Visual Studio 2022\PARTS_Web\app\env_test\Lib\site-packages\setuptools\_distutils\cmd.py", "Python", 0, 0, 0, -275, 0, -71, -58, -404
"c:\Users\edwar\OneDrive\Documents\Programming\Visual Studio 2022\PARTS_Web\app\env_test\Lib\site-packages\setuptools\_distutils\command\__init__.py", "Python", 0, 0, 0, -23, 0, -6, -3, -32
"c:\Users\edwar\OneDrive\Documents\Programming\Visual Studio 2022\PARTS_Web\app\env_test\Lib\site-packages\setuptools\_distutils\command\bdist.py", "Python", 0, 0, 0, -105, 0, -14, -25, -144
"c:\Users\edwar\OneDrive\Documents\Programming\Visual Studio 2022\PARTS_Web\app\env_test\Lib\site-packages\setuptools\_distutils\command\bdist_dumb.py", "Python", 0, 0, 0, -102, 0, -3, -19, -124
"c:\Users\edwar\OneDrive\Documents\Programming\Visual Studio 2022\PARTS_Web\app\env_test\Lib\site-packages\setuptools\_distutils\command\bdist_msi.py", "Python", 0, 0, 0, -570, 0, -93, -87, -750
"c:\Users\edwar\OneDrive\Documents\Programming\Visual Studio 2022\PARTS_Web\app\env_test\Lib\site-packages\setuptools\_distutils\command\bdist_rpm.py", "Python", 0, 0, 0, -435, 0, -59, -86, -580
"c:\Users\edwar\OneDrive\Documents\Programming\Visual Studio 2022\PARTS_Web\app\env_test\Lib\site-packages\setuptools\_distutils\command\bdist_wininst.py", "Python", 0, 0, 0, -265, 0, -61, -52, -378
"c:\Users\edwar\OneDrive\Documents\Programming\Visual Studio 2022\PARTS_Web\app\env_test\Lib\site-packages\setuptools\_distutils\command\build.py", "Python", 0, 0, 0, -107, 0, -22, -29, -158
"c:\Users\edwar\OneDrive\Documents\Programming\Visual Studio 2022\PARTS_Web\app\env_test\Lib\site-packages\setuptools\_distutils\command\build_clib.py", "Python", 0, 0, 0, -138, 0, -27, -45, -210
"c:\Users\edwar\OneDrive\Documents\Programming\Visual Studio 2022\PARTS_Web\app\env_test\Lib\site-packages\setuptools\_distutils\command\build_ext.py", "Python", 0, 0, 0, -500, 0, -153, -103, -756
"c:\Users\edwar\OneDrive\Documents\Programming\Visual Studio 2022\PARTS_Web\app\env_test\Lib\site-packages\setuptools\_distutils\command\build_py.py", "Python", 0, 0, 0, -277, 0, -81, -59, -417
"c:\Users\edwar\OneDrive\Documents\Programming\Visual Studio 2022\PARTS_Web\app\env_test\Lib\site-packages\setuptools\_distutils\command\build_scripts.py", "Python", 0, 0, 0, -126, 0, -13, -22, -161
"c:\Users\edwar\OneDrive\Documents\Programming\Visual Studio 2022\PARTS_Web\app\env_test\Lib\site-packages\setuptools\_distutils\command\check.py", "Python", 0, 0, 0, -118, 0, -7, -24, -149
"c:\Users\edwar\OneDrive\Documents\Programming\Visual Studio 2022\PARTS_Web\app\env_test\Lib\site-packages\setuptools\_distutils\command\clean.py", "Python", 0, 0, 0, -59, 0, -6, -12, -77
"c:\Users\edwar\OneDrive\Documents\Programming\Visual Studio 2022\PARTS_Web\app\env_test\Lib\site-packages\setuptools\_distutils\command\config.py", "Python", 0, 0, 0, -273, 0, -21, -51, -345
"c:\Users\edwar\OneDrive\Documents\Programming\Visual Studio 2022\PARTS_Web\app\env_test\Lib\site-packages\setuptools\_distutils\command\install.py", "Python", 0, 0, 0, -452, 0, -122, -104, -678
"c:\Users\edwar\OneDrive\Documents\Programming\Visual Studio 2022\PARTS_Web\app\env_test\Lib\site-packages\setuptools\_distutils\command\install_data.py", "Python", 0, 0, 0, -59, 0, -7, -14, -80
"c:\Users\edwar\OneDrive\Documents\Programming\Visual Studio 2022\PARTS_Web\app\env_test\Lib\site-packages\setuptools\_distutils\command\install_egg_info.py", "Python", 0, 0, 0, -55, 0, -3, -20, -78
"c:\Users\edwar\OneDrive\Documents\Programming\Visual Studio 2022\PARTS_Web\app\env_test\Lib\site-packages\setuptools\_distutils\command\install_headers.py", "Python", 0, 0, 0, -32, 0, -1, -15, -48
"c:\Users\edwar\OneDrive\Documents\Programming\Visual Studio 2022\PARTS_Web\app\env_test\Lib\site-packages\setuptools\_distutils\command\install_lib.py", "Python", 0, 0, 0, -140, 0, -36, -42, -218
"c:\Users\edwar\OneDrive\Documents\Programming\Visual Studio 2022\PARTS_Web\app\env_test\Lib\site-packages\setuptools\_distutils\command\install_scripts.py", "Python", 0, 0, 0, -44, 0, -3, -14, -61
"c:\Users\edwar\OneDrive\Documents\Programming\Visual Studio 2022\PARTS_Web\app\env_test\Lib\site-packages\setuptools\_distutils\command\py37compat.py", "Python", 0, 0, 0, -23, 0, 0, -8, -31
"c:\Users\edwar\OneDrive\Documents\Programming\Visual Studio 2022\PARTS_Web\app\env_test\Lib\site-packages\setuptools\_distutils\command\register.py", "Python", 0, 0, 0, -251, 0, -20, -34, -305
"c:\Users\edwar\OneDrive\Documents\Programming\Visual Studio 2022\PARTS_Web\app\env_test\Lib\site-packages\setuptools\_distutils\command\sdist.py", "Python", 0, 0, 0, -373, 0, -47, -75, -495
"c:\Users\edwar\OneDrive\Documents\Programming\Visual Studio 2022\PARTS_Web\app\env_test\Lib\site-packages\setuptools\_distutils\command\upload.py", "Python", 0, 0, 0, -162, 0, -22, -31, -215
"c:\Users\edwar\OneDrive\Documents\Programming\Visual Studio 2022\PARTS_Web\app\env_test\Lib\site-packages\setuptools\_distutils\config.py", "Python", 0, 0, 0, -103, 0, -9, -19, -131
"c:\Users\edwar\OneDrive\Documents\Programming\Visual Studio 2022\PARTS_Web\app\env_test\Lib\site-packages\setuptools\_distutils\core.py", "Python", 0, 0, 0, -170, 0, -25, -40, -235
"c:\Users\edwar\OneDrive\Documents\Programming\Visual Studio 2022\PARTS_Web\app\env_test\Lib\site-packages\setuptools\_distutils\cygwinccompiler.py", "Python", 0, 0, 0, -237, 0, -111, -56, -404
"c:\Users\edwar\OneDrive\Documents\Programming\Visual Studio 2022\PARTS_Web\app\env_test\Lib\site-packages\setuptools\_distutils\debug.py", "Python", 0, 0, 0, -2, 0, -2, -2, -6
"c:\Users\edwar\OneDrive\Documents\Programming\Visual Studio 2022\PARTS_Web\app\env_test\Lib\site-packages\setuptools\_distutils\dep_util.py", "Python", 0, 0, 0, -66, 0, -9, -18, -93
"c:\Users\edwar\OneDrive\Documents\Programming\Visual Studio 2022\PARTS_Web\app\env_test\Lib\site-packages\setuptools\_distutils\dir_util.py", "Python", 0, 0, 0, -156, 0, -18, -37, -211
"c:\Users\edwar\OneDrive\Documents\Programming\Visual Studio 2022\PARTS_Web\app\env_test\Lib\site-packages\setuptools\_distutils\dist.py", "Python", 0, 0, 0, -900, 0, -164, -194, -1258
"c:\Users\edwar\OneDrive\Documents\Programming\Visual Studio 2022\PARTS_Web\app\env_test\Lib\site-packages\setuptools\_distutils\errors.py", "Python", 0, 0, 0, -75, 0, -1, -22, -98
"c:\Users\edwar\OneDrive\Documents\Programming\Visual Studio 2022\PARTS_Web\app\env_test\Lib\site-packages\setuptools\_distutils\extension.py", "Python", 0, 0, 0, -189, 0, -27, -25, -241
"c:\Users\edwar\OneDrive\Documents\Programming\Visual Studio 2022\PARTS_Web\app\env_test\Lib\site-packages\setuptools\_distutils\fancy_getopt.py", "Python", 0, 0, 0, -308, 0, -78, -72, -458
"c:\Users\edwar\OneDrive\Documents\Programming\Visual Studio 2022\PARTS_Web\app\env_test\Lib\site-packages\setuptools\_distutils\file_util.py", "Python", 0, 0, 0, -181, 0, -19, -39, -239
"c:\Users\edwar\OneDrive\Documents\Programming\Visual Studio 2022\PARTS_Web\app\env_test\Lib\site-packages\setuptools\_distutils\filelist.py", "Python", 0, 0, 0, -243, 0, -28, -57, -328
"c:\Users\edwar\OneDrive\Documents\Programming\Visual Studio 2022\PARTS_Web\app\env_test\Lib\site-packages\setuptools\_distutils\log.py", "Python", 0, 0, 0, -57, 0, -4, -17, -78
"c:\Users\edwar\OneDrive\Documents\Programming\Visual Studio 2022\PARTS_Web\app\env_test\Lib\site-packages\setuptools\_distutils\msvc9compiler.py", "Python", 0, 0, 0, -584, 0, -107, -98, -789
"c:\Users\edwar\OneDrive\Documents\Programming\Visual Studio 2022\PARTS_Web\app\env_test\Lib\site-packages\setuptools\_distutils\msvccompiler.py", "Python", 0, 0, 0, -493, 0, -62, -89, -644
"c:\Users\edwar\OneDrive\Documents\Programming\Visual Studio 2022\PARTS_Web\app\env_test\Lib\site-packages\setuptools\_distutils\py35compat.py", "Python", 0, 0, 0, -15, 0, 0, -5, -20
"c:\Users\edwar\OneDrive\Documents\Programming\Visual Studio 2022\PARTS_Web\app\env_test\Lib\site-packages\setuptools\_distutils\py38compat.py", "Python", 0, 0, 0, -7, 0, 0, -1, -8
"c:\Users\edwar\OneDrive\Documents\Programming\Visual Studio 2022\PARTS_Web\app\env_test\Lib\site-packages\setuptools\_distutils\spawn.py", "Python", 0, 0, 0, -92, 0, -10, -24, -126
"c:\Users\edwar\OneDrive\Documents\Programming\Visual Studio 2022\PARTS_Web\app\env_test\Lib\site-packages\setuptools\_distutils\sysconfig.py", "Python", 0, 0, 0, -412, 0, -81, -81, -574
"c:\Users\edwar\OneDrive\Documents\Programming\Visual Studio 2022\PARTS_Web\app\env_test\Lib\site-packages\setuptools\_distutils\text_file.py", "Python", 0, 0, 0, -203, 0, -43, -41, -287
"c:\Users\edwar\OneDrive\Documents\Programming\Visual Studio 2022\PARTS_Web\app\env_test\Lib\site-packages\setuptools\_distutils\unixccompiler.py", "Python", 0, 0, 0, -198, 0, -90, -41, -329
"c:\Users\edwar\OneDrive\Documents\Programming\Visual Studio 2022\PARTS_Web\app\env_test\Lib\site-packages\setuptools\_distutils\util.py", "Python", 0, 0, 0, -404, 0, -69, -89, -562
"c:\Users\edwar\OneDrive\Documents\Programming\Visual Studio 2022\PARTS_Web\app\env_test\Lib\site-packages\setuptools\_distutils\version.py", "Python", 0, 0, 0, -191, 0, -98, -59, -348
"c:\Users\edwar\OneDrive\Documents\Programming\Visual Studio 2022\PARTS_Web\app\env_test\Lib\site-packages\setuptools\_distutils\versionpredicate.py", "Python", 0, 0, 0, -129, 0, -5, -33, -167
"c:\Users\edwar\OneDrive\Documents\Programming\Visual Studio 2022\PARTS_Web\app\env_test\Lib\site-packages\setuptools\_imp.py", "Python", 0, 0, 0, -66, 0, 0, -17, -83
"c:\Users\edwar\OneDrive\Documents\Programming\Visual Studio 2022\PARTS_Web\app\env_test\Lib\site-packages\setuptools\_vendor\__init__.py", "Python", 0, 0, 0, 0, 0, 0, -1, -1
"c:\Users\edwar\OneDrive\Documents\Programming\Visual Studio 2022\PARTS_Web\app\env_test\Lib\site-packages\setuptools\_vendor\ordered_set.py", "Python", 0, 0, 0, -405, 0, -15, -69, -489
"c:\Users\edwar\OneDrive\Documents\Programming\Visual Studio 2022\PARTS_Web\app\env_test\Lib\site-packages\setuptools\_vendor\packaging\__about__.py", "Python", 0, 0, 0, -19, 0, -3, -6, -28
"c:\Users\edwar\OneDrive\Documents\Programming\Visual Studio 2022\PARTS_Web\app\env_test\Lib\site-packages\setuptools\_vendor\packaging\__init__.py", "Python", 0, 0, 0, -21, 0, -3, -3, -27
"c:\Users\edwar\OneDrive\Documents\Programming\Visual Studio 2022\PARTS_Web\app\env_test\Lib\site-packages\setuptools\_vendor\packaging\_compat.py", "Python", 0, 0, 0, -19, 0, -9, -11, -39
"c:\Users\edwar\OneDrive\Documents\Programming\Visual Studio 2022\PARTS_Web\app\env_test\Lib\site-packages\setuptools\_vendor\packaging\_structures.py", "Python", 0, 0, 0, -41, 0, -21, -25, -87
"c:\Users\edwar\OneDrive\Documents\Programming\Visual Studio 2022\PARTS_Web\app\env_test\Lib\site-packages\setuptools\_vendor\packaging\_typing.py", "Python", 0, 0, 0, -29, 0, -8, -12, -49
"c:\Users\edwar\OneDrive\Documents\Programming\Visual Studio 2022\PARTS_Web\app\env_test\Lib\site-packages\setuptools\_vendor\packaging\markers.py", "Python", 0, 0, 0, -224, 0, -28, -77, -329
"c:\Users\edwar\OneDrive\Documents\Programming\Visual Studio 2022\PARTS_Web\app\env_test\Lib\site-packages\setuptools\_vendor\packaging\requirements.py", "Python", 0, 0, 0, -100, 0, -12, -34, -146
"c:\Users\edwar\OneDrive\Documents\Programming\Visual Studio 2022\PARTS_Web\app\env_test\Lib\site-packages\setuptools\_vendor\packaging\specifiers.py", "Python", 0, 0, 0, -490, 0, -216, -158, -864
"c:\Users\edwar\OneDrive\Documents\Programming\Visual Studio 2022\PARTS_Web\app\env_test\Lib\site-packages\setuptools\_vendor\packaging\tags.py", "Python", 0, 0, 0, -543, 0, -88, -121, -752
"c:\Users\edwar\OneDrive\Documents\Programming\Visual Studio 2022\PARTS_Web\app\env_test\Lib\site-packages\setuptools\_vendor\packaging\utils.py", "Python", 0, 0, 0, -33, 0, -14, -19, -66
"c:\Users\edwar\OneDrive\Documents\Programming\Visual Studio 2022\PARTS_Web\app\env_test\Lib\site-packages\setuptools\_vendor\packaging\version.py", "Python", 0, 0, 0, -325, 0, -100, -111, -536
"c:\Users\edwar\OneDrive\Documents\Programming\Visual Studio 2022\PARTS_Web\app\env_test\Lib\site-packages\setuptools\_vendor\pyparsing.py", "Python", 0, 0, 0, -4648, 0, -255, -840, -5743
"c:\Users\edwar\OneDrive\Documents\Programming\Visual Studio 2022\PARTS_Web\app\env_test\Lib\site-packages\setuptools\archive_util.py", "Python", 0, 0, 0, -156, 0, -8, -42, -206
"c:\Users\edwar\OneDrive\Documents\Programming\Visual Studio 2022\PARTS_Web\app\env_test\Lib\site-packages\setuptools\build_meta.py", "Python", 0, 0, 0, -200, 0, -20, -62, -282
"c:\Users\edwar\OneDrive\Documents\Programming\Visual Studio 2022\PARTS_Web\app\env_test\Lib\site-packages\setuptools\command\__init__.py", "Python", 0, 0, 0, -13, 0, 0, -5, -18
"c:\Users\edwar\OneDrive\Documents\Programming\Visual Studio 2022\PARTS_Web\app\env_test\Lib\site-packages\setuptools\command\alias.py", "Python", 0, 0, 0, -62, 0, 0, -17, -79
"c:\Users\edwar\OneDrive\Documents\Programming\Visual Studio 2022\PARTS_Web\app\env_test\Lib\site-packages\setuptools\command\bdist_egg.py", "Python", 0, 0, 0, -362, 0, -17, -78, -457
"c:\Users\edwar\OneDrive\Documents\Programming\Visual Studio 2022\PARTS_Web\app\env_test\Lib\site-packages\setuptools\command\bdist_rpm.py", "Python", 0, 0, 0, -24, 0, -1, -7, -32
"c:\Users\edwar\OneDrive\Documents\Programming\Visual Studio 2022\PARTS_Web\app\env_test\Lib\site-packages\setuptools\command\build_clib.py", "Python", 0, 0, 0, -77, 0, -13, -12, -102
"c:\Users\edwar\OneDrive\Documents\Programming\Visual Studio 2022\PARTS_Web\app\env_test\Lib\site-packages\setuptools\command\build_ext.py", "Python", 0, 0, 0, -255, 0, -30, -38, -323
"c:\Users\edwar\OneDrive\Documents\Programming\Visual Studio 2022\PARTS_Web\app\env_test\Lib\site-packages\setuptools\command\build_py.py", "Python", 0, 0, 0, -216, 0, -13, -42, -271
"c:\Users\edwar\OneDrive\Documents\Programming\Visual Studio 2022\PARTS_Web\app\env_test\Lib\site-packages\setuptools\command\develop.py", "Python", 0, 0, 0, -162, 0, -17, -38, -217
"c:\Users\edwar\OneDrive\Documents\Programming\Visual Studio 2022\PARTS_Web\app\env_test\Lib\site-packages\setuptools\command\dist_info.py", "Python", 0, 0, 0, -26, 0, 0, -11, -37
"c:\Users\edwar\OneDrive\Documents\Programming\Visual Studio 2022\PARTS_Web\app\env_test\Lib\site-packages\setuptools\command\easy_install.py", "Python", 0, 0, 0, -1804, 0, -147, -340, -2291
"c:\Users\edwar\OneDrive\Documents\Programming\Visual Studio 2022\PARTS_Web\app\env_test\Lib\site-packages\setuptools\command\egg_info.py", "Python", 0, 0, 0, -554, 0, -53, -121, -728
"c:\Users\edwar\OneDrive\Documents\Programming\Visual Studio 2022\PARTS_Web\app\env_test\Lib\site-packages\setuptools\command\install.py", "Python", 0, 0, 0, -94, 0, -10, -22, -126
"c:\Users\edwar\OneDrive\Documents\Programming\Visual Studio 2022\PARTS_Web\app\env_test\Lib\site-packages\setuptools\command\install_egg_info.py", "Python", 0, 0, 0, -47, 0, -4, -12, -63
"c:\Users\edwar\OneDrive\Documents\Programming\Visual Studio 2022\PARTS_Web\app\env_test\Lib\site-packages\setuptools\command\install_lib.py", "Python", 0, 0, 0, -93, 0, -6, -24, -123
"c:\Users\edwar\OneDrive\Documents\Programming\Visual Studio 2022\PARTS_Web\app\env_test\Lib\site-packages\setuptools\command\install_scripts.py", "Python", 0, 0, 0, -55, 0, -4, -11, -70
"c:\Users\edwar\OneDrive\Documents\Programming\Visual Studio 2022\PARTS_Web\app\env_test\Lib\site-packages\setuptools\command\launcher manifest.xml", "XML", 0, 0, 0, 0, -14, -1, -1, -16
"c:\Users\edwar\OneDrive\Documents\Programming\Visual Studio 2022\PARTS_Web\app\env_test\Lib\site-packages\setuptools\command\py36compat.py", "Python", 0, 0, 0, -105, 0, -11, -19, -135
"c:\Users\edwar\OneDrive\Documents\Programming\Visual Studio 2022\PARTS_Web\app\env_test\Lib\site-packages\setuptools\command\register.py", "Python", 0, 0, 0, -12, 0, 0, -7, -19
"c:\Users\edwar\OneDrive\Documents\Programming\Visual Studio 2022\PARTS_Web\app\env_test\Lib\site-packages\setuptools\command\rotate.py", "Python", 0, 0, 0, -54, 0, 0, -11, -65
"c:\Users\edwar\OneDrive\Documents\Programming\Visual Studio 2022\PARTS_Web\app\env_test\Lib\site-packages\setuptools\command\saveopts.py", "Python", 0, 0, 0, -14, 0, 0, -9, -23
"c:\Users\edwar\OneDrive\Documents\Programming\Visual Studio 2022\PARTS_Web\app\env_test\Lib\site-packages\setuptools\command\sdist.py", "Python", 0, 0, 0, -183, 0, -11, -42, -236
"c:\Users\edwar\OneDrive\Documents\Programming\Visual Studio 2022\PARTS_Web\app\env_test\Lib\site-packages\setuptools\command\setopt.py", "Python", 0, 0, 0, -125, 0, 0, -24, -149
"c:\Users\edwar\OneDrive\Documents\Programming\Visual Studio 2022\PARTS_Web\app\env_test\Lib\site-packages\setuptools\command\test.py", "Python", 0, 0, 0, -219, 0, -9, -47, -275
"c:\Users\edwar\OneDrive\Documents\Programming\Visual Studio 2022\PARTS_Web\app\env_test\Lib\site-packages\setuptools\command\upload.py", "Python", 0, 0, 0, -12, 0, 0, -6, -18
"c:\Users\edwar\OneDrive\Documents\Programming\Visual Studio 2022\PARTS_Web\app\env_test\Lib\site-packages\setuptools\command\upload_docs.py", "Python", 0, 0, 0, -169, 0, -9, -25, -203
"c:\Users\edwar\OneDrive\Documents\Programming\Visual Studio 2022\PARTS_Web\app\env_test\Lib\site-packages\setuptools\config.py", "Python", 0, 0, 0, -538, 0, -10, -163, -711
"c:\Users\edwar\OneDrive\Documents\Programming\Visual Studio 2022\PARTS_Web\app\env_test\Lib\site-packages\setuptools\dep_util.py", "Python", 0, 0, 0, -17, 0, -4, -5, -26
"c:\Users\edwar\OneDrive\Documents\Programming\Visual Studio 2022\PARTS_Web\app\env_test\Lib\site-packages\setuptools\depends.py", "Python", 0, 0, 0, -129, 0, -3, -44, -176
"c:\Users\edwar\OneDrive\Documents\Programming\Visual Studio 2022\PARTS_Web\app\env_test\Lib\site-packages\setuptools\dist.py", "Python", 0, 0, 0, -828, 0, -45, -185, -1058
"c:\Users\edwar\OneDrive\Documents\Programming\Visual Studio 2022\PARTS_Web\app\env_test\Lib\site-packages\setuptools\errors.py", "Python", 0, 0, 0, -11, 0, 0, -6, -17
"c:\Users\edwar\OneDrive\Documents\Programming\Visual Studio 2022\PARTS_Web\app\env_test\Lib\site-packages\setuptools\extension.py", "Python", 0, 0, 0, -38, 0, -5, -13, -56
"c:\Users\edwar\OneDrive\Documents\Programming\Visual Studio 2022\PARTS_Web\app\env_test\Lib\site-packages\setuptools\extern\__init__.py", "Python", 0, 0, 0, -61, 0, 0, -13, -74
"c:\Users\edwar\OneDrive\Documents\Programming\Visual Studio 2022\PARTS_Web\app\env_test\Lib\site-packages\setuptools\glob.py", "Python", 0, 0, 0, -118, 0, -14, -36, -168
"c:\Users\edwar\OneDrive\Documents\Programming\Visual Studio 2022\PARTS_Web\app\env_test\Lib\site-packages\setuptools\installer.py", "Python", 0, 0, 0, -80, 0, -9, -9, -98
"c:\Users\edwar\OneDrive\Documents\Programming\Visual Studio 2022\PARTS_Web\app\env_test\Lib\site-packages\setuptools\launch.py", "Python", 0, 0, 0, -27, 0, -2, -8, -37
"c:\Users\edwar\OneDrive\Documents\Programming\Visual Studio 2022\PARTS_Web\app\env_test\Lib\site-packages\setuptools\lib2to3_ex.py", "Python", 0, 0, 0, -54, 0, -2, -13, -69
"c:\Users\edwar\OneDrive\Documents\Programming\Visual Studio 2022\PARTS_Web\app\env_test\Lib\site-packages\setuptools\monkey.py", "Python", 0, 0, 0, -124, 0, -14, -40, -178
"c:\Users\edwar\OneDrive\Documents\Programming\Visual Studio 2022\PARTS_Web\app\env_test\Lib\site-packages\setuptools\msvc.py", "Python", 0, 0, 0, -1466, 0, -64, -297, -1827
"c:\Users\edwar\OneDrive\Documents\Programming\Visual Studio 2022\PARTS_Web\app\env_test\Lib\site-packages\setuptools\namespaces.py", "Python", 0, 0, 0, -86, 0, -1, -21, -108
"c:\Users\edwar\OneDrive\Documents\Programming\Visual Studio 2022\PARTS_Web\app\env_test\Lib\site-packages\setuptools\package_index.py", "Python", 0, 0, 0, -902, 0, -63, -181, -1146
"c:\Users\edwar\OneDrive\Documents\Programming\Visual Studio 2022\PARTS_Web\app\env_test\Lib\site-packages\setuptools\py34compat.py", "Python", 0, 0, 0, -10, 0, 0, -4, -14
"c:\Users\edwar\OneDrive\Documents\Programming\Visual Studio 2022\PARTS_Web\app\env_test\Lib\site-packages\setuptools\sandbox.py", "Python", 0, 0, 0, -384, 0, -9, -104, -497
"c:\Users\edwar\OneDrive\Documents\Programming\Visual Studio 2022\PARTS_Web\app\env_test\Lib\site-packages\setuptools\ssl_support.py", "Python", 0, 0, 0, -189, 0, -31, -47, -267
"c:\Users\edwar\OneDrive\Documents\Programming\Visual Studio 2022\PARTS_Web\app\env_test\Lib\site-packages\setuptools\unicode_utils.py", "Python", 0, 0, 0, -32, 0, -1, -10, -43
"c:\Users\edwar\OneDrive\Documents\Programming\Visual Studio 2022\PARTS_Web\app\env_test\Lib\site-packages\setuptools\version.py", "Python", 0, 0, 0, -5, 0, 0, -2, -7
"c:\Users\edwar\OneDrive\Documents\Programming\Visual Studio 2022\PARTS_Web\app\env_test\Lib\site-packages\setuptools\wheel.py", "Python", 0, 0, 0, -178, 0, -13, -23, -214
"c:\Users\edwar\OneDrive\Documents\Programming\Visual Studio 2022\PARTS_Web\app\env_test\Lib\site-packages\setuptools\windows_support.py", "Python", 0, 0, 0, -21, 0, 0, -9, -30
"c:\Users\edwar\OneDrive\Documents\Programming\Visual Studio 2022\PARTS_Web\app\env_test\Scripts\Activate.ps1", "PowerShell", 0, 0, -104, 0, 0, -105, -33, -242
"c:\Users\edwar\OneDrive\Documents\Programming\Visual Studio 2022\PARTS_Web\app\env_test\Scripts\activate.bat", "Batch", 0, -23, 0, 0, 0, -1, -10, -34
"c:\Users\edwar\OneDrive\Documents\Programming\Visual Studio 2022\PARTS_Web\app\env_test\Scripts\deactivate.bat", "Batch", 0, -15, 0, 0, 0, 0, -7, -22
"c:\Users\edwar\OneDrive\Documents\Programming\Visual Studio 2022\PARTS_Web\app\env_test\pyvenv.cfg", "Properties", -3, 0, 0, 0, 0, 0, -1, -4
"c:\Users\edwar\OneDrive\Documents\Programming\Visual Studio 2022\PARTS_Web\app\env_web\Lib\site-packages\_distutils_hack\__init__.py", "Python", 0, 0, 0, -93, 0, -3, -33, -129
"c:\Users\edwar\OneDrive\Documents\Programming\Visual Studio 2022\PARTS_Web\app\env_web\Lib\site-packages\_distutils_hack\override.py", "Python", 0, 0, 0, -1, 0, 0, -1, -2
"c:\Users\edwar\OneDrive\Documents\Programming\Visual Studio 2022\PARTS_Web\app\env_web\Lib\site-packages\pip\__init__.py", "Python", 0, 0, 0, -8, 0, 0, -6, -14
"c:\Users\edwar\OneDrive\Documents\Programming\Visual Studio 2022\PARTS_Web\app\env_web\Lib\site-packages\pip\__main__.py", "Python", 0, 0, 0, -10, 0, -10, -5, -25
"c:\Users\edwar\OneDrive\Documents\Programming\Visual Studio 2022\PARTS_Web\app\env_web\Lib\site-packages\pip\__pip-runner__.py", "Python", 0, 0, 0, -29, 0, -4, -18, -51
"c:\Users\edwar\OneDrive\Documents\Programming\Visual Studio 2022\PARTS_Web\app\env_web\Lib\site-packages\pip\_internal\__init__.py", "Python", 0, 0, 0, -10, 0, -2, -7, -19
"c:\Users\edwar\OneDrive\Documents\Programming\Visual Studio 2022\PARTS_Web\app\env_web\Lib\site-packages\pip\_internal\build_env.py", "Python", 0, 0, 0, -252, 0, -15, -45, -312
"c:\Users\edwar\OneDrive\Documents\Programming\Visual Studio 2022\PARTS_Web\app\env_web\Lib\site-packages\pip\_internal\cache.py", "Python", 0, 0, 0, -221, 0, -19, -51, -291
"c:\Users\edwar\OneDrive\Documents\Programming\Visual Studio 2022\PARTS_Web\app\env_web\Lib\site-packages\pip\_internal\cli\__init__.py", "Python", 0, 0, 0, -2, 0, -1, -2, -5
"c:\Users\edwar\OneDrive\Documents\Programming\Visual Studio 2022\PARTS_Web\app\env_web\Lib\site-packages\pip\_internal\cli\autocompletion.py", "Python", 0, 0, 0, -135, 0, -19, -19, -173
"c:\Users\edwar\OneDrive\Documents\Programming\Visual Studio 2022\PARTS_Web\app\env_web\Lib\site-packages\pip\_internal\cli\base_command.py", "Python", 0, 0, 0, -175, 0, -22, -40, -237
"c:\Users\edwar\OneDrive\Documents\Programming\Visual Studio 2022\PARTS_Web\app\env_web\Lib\site-packages\pip\_internal\cli\cmdoptions.py", "Python", 0, 0, 0, -883, 0, -38, -154, -1075
"c:\Users\edwar\OneDrive\Documents\Programming\Visual Studio 2022\PARTS_Web\app\env_web\Lib\site-packages\pip\_internal\cli\command_context.py", "Python", 0, 0, 0, -20, 0, 0, -8, -28
"c:\Users\edwar\OneDrive\Documents\Programming\Visual Studio 2022\PARTS_Web\app\env_web\Lib\site-packages\pip\_internal\cli\main.py", "Python", 0, 0, 0, -34, 0, -30, -16, -80
"c:\Users\edwar\OneDrive\Documents\Programming\Visual Studio 2022\PARTS_Web\app\env_web\Lib\site-packages\pip\_internal\cli\main_parser.py", "Python", 0, 0, 0, -82, 0, -24, -29, -135
"c:\Users\edwar\OneDrive\Documents\Programming\Visual Studio 2022\PARTS_Web\app\env_web\Lib\site-packages\pip\_internal\cli\parser.py", "Python", 0, 0, 0, -222, 0, -20, -53, -295
"c:\Users\edwar\OneDrive\Documents\Programming\Visual Studio 2022\PARTS_Web\app\env_web\Lib\site-packages\pip\_internal\cli\progress_bars.py", "Python", 0, 0, 0, -58, 0, 0, -11, -69
"c:\Users\edwar\OneDrive\Documents\Programming\Visual Studio 2022\PARTS_Web\app\env_web\Lib\site-packages\pip\_internal\cli\req_command.py", "Python", 0, 0, 0, -408, 0, -29, -69, -506
"c:\Users\edwar\OneDrive\Documents\Programming\Visual Studio 2022\PARTS_Web\app\env_web\Lib\site-packages\pip\_internal\cli\spinners.py", "Python", 0, 0, 0, -114, 0, -18, -28, -160
"c:\Users\edwar\OneDrive\Documents\Programming\Visual Studio 2022\PARTS_Web\app\env_web\Lib\site-packages\pip\_internal\cli\status_codes.py", "Python", 0, 0, 0, -6, 0, 0, -1, -7
"c:\Users\edwar\OneDrive\Documents\Programming\Visual Studio 2022\PARTS_Web\app\env_web\Lib\site-packages\pip\_internal\commands\__init__.py", "Python", 0, 0, 0, -113, 0, -7, -13, -133
"c:\Users\edwar\OneDrive\Documents\Programming\Visual Studio 2022\PARTS_Web\app\env_web\Lib\site-packages\pip\_internal\commands\cache.py", "Python", 0, 0, 0, -163, 0, -20, -43, -226
"c:\Users\edwar\OneDrive\Documents\Programming\Visual Studio 2022\PARTS_Web\app\env_web\Lib\site-packages\pip\_internal\commands\check.py", "Python", 0, 0, 0, -45, 0, 0, -10, -55
"c:\Users\edwar\OneDrive\Documents\Programming\Visual Studio 2022\PARTS_Web\app\env_web\Lib\site-packages\pip\_internal\commands\completion.py", "Python", 0, 0, 0, -116, 0, -5, -10, -131
"c:\Users\edwar\OneDrive\Documents\Programming\Visual Studio 2022\PARTS_Web\app\env_web\Lib\site-packages\pip\_internal\commands\configuration.py", "Python", 0, 0, 0, -224, 0, -12, -45, -281
"c:\Users\edwar\OneDrive\Documents\Programming\Visual Studio 2022\PARTS_Web\app\env_web\Lib\site-packages\pip\_internal\commands\debug.py", "Python", 0, 0, 0, -149, 0, -9, -44, -202
"c:\Users\edwar\OneDrive\Documents\Programming\Visual Studio 2022\PARTS_Web\app\env_web\Lib\site-packages\pip\_internal\commands\download.py", "Python", 0, 0, 0, -117, 0, -2, -29, -148
"c:\Users\edwar\OneDrive\Documents\Programming\Visual Studio 2022\PARTS_Web\app\env_web\Lib\site-packages\pip\_internal\commands\freeze.py", "Python", 0, 0, 0, -91, 0, 0, -18, -109
"c:\Users\edwar\OneDrive\Documents\Programming\Visual Studio 2022\PARTS_Web\app\env_web\Lib\site-packages\pip\_internal\commands\hash.py", "Python", 0, 0, 0, -48, 0, 0, -12, -60
"c:\Users\edwar\OneDrive\Documents\Programming\Visual Studio 2022\PARTS_Web\app\env_web\Lib\site-packages\pip\_internal\commands\help.py", "Python", 0, 0, 0, -29, 0, -1, -12, -42
"c:\Users\edwar\OneDrive\Documents\Programming\Visual Studio 2022\PARTS_Web\app\env_web\Lib\site-packages\pip\_internal\commands\index.py", "Python", 0, 0, 0, -108, 0, -4, -28, -140
"c:\Users\edwar\OneDrive\Documents\Programming\Visual Studio 2022\PARTS_Web\app\env_web\Lib\site-packages\pip\_internal\commands\inspect.py", "Python", 0, 0, 0, -77, 0, -6, -10, -93
"c:\Users\edwar\OneDrive\Documents\Programming\Visual Studio 2022\PARTS_Web\app\env_web\Lib\site-packages\pip\_internal\commands\install.py", "Python", 0, 0, 0, -646, 0, -36, -93, -775
"c:\Users\edwar\OneDrive\Documents\Programming\Visual Studio 2022\PARTS_Web\app\env_web\Lib\site-packages\pip\_internal\commands\list.py", "Python", 0, 0, 0, -299, 0, -13, -57, -369
"c:\Users\edwar\OneDrive\Documents\Programming\Visual Studio 2022\PARTS_Web\app\env_web\Lib\site-packages\pip\_internal\commands\search.py", "Python", 0, 0, 0, -142, 0, -2, -31, -175
"c:\Users\edwar\OneDrive\Documents\Programming\Visual Studio 2022\PARTS_Web\app\env_web\Lib\site-packages\pip\_internal\commands\show.py", "Python", 0, 0, 0, -162, 0, 0, -28, -190
"c:\Users\edwar\OneDrive\Documents\Programming\Visual Studio 2022\PARTS_Web\app\env_web\Lib\site-packages\pip\_internal\commands\uninstall.py", "Python", 0, 0, 0, -99, 0, 0, -15, -114
"c:\Users\edwar\OneDrive\Documents\Programming\Visual Studio 2022\PARTS_Web\app\env_web\Lib\site-packages\pip\_internal\commands\wheel.py", "Python", 0, 0, 0, -151, 0, -2, -31, -184
"c:\Users\edwar\OneDrive\Documents\Programming\Visual Studio 2022\PARTS_Web\app\env_web\Lib\site-packages\pip\_internal\configuration.py", "Python", 0, 0, 0, -279, 0, -33, -72, -384
"c:\Users\edwar\OneDrive\Documents\Programming\Visual Studio 2022\PARTS_Web\app\env_web\Lib\site-packages\pip\_internal\distributions\__init__.py", "Python", 0, 0, 0, -13, 0, -4, -5, -22
"c:\Users\edwar\OneDrive\Documents\Programming\Visual Studio 2022\PARTS_Web\app\env_web\Lib\site-packages\pip\_internal\distributions\base.py", "Python", 0, 0, 0, -38, 0, 0, -14, -52
"c:\Users\edwar\OneDrive\Documents\Programming\Visual Studio 2022\PARTS_Web\app\env_web\Lib\site-packages\pip\_internal\distributions\installed.py", "Python", 0, 0, 0, -22, 0, 0, -8, -30
"c:\Users\edwar\OneDrive\Documents\Programming\Visual Studio 2022\PARTS_Web\app\env_web\Lib\site-packages\pip\_internal\distributions\sdist.py", "Python", 0, 0, 0, -122, 0, -18, -17, -157
"c:\Users\edwar\OneDrive\Documents\Programming\Visual Studio 2022\PARTS_Web\app\env_web\Lib\site-packages\pip\_internal\distributions\wheel.py", "Python", 0, 0, 0, -32, 0, 0, -9, -41
"c:\Users\edwar\OneDrive\Documents\Programming\Visual Studio 2022\PARTS_Web\app\env_web\Lib\site-packages\pip\_internal\exceptions.py", "Python", 0, 0, 0, -546, 0, -23, -160, -729
"c:\Users\edwar\OneDrive\Documents\Programming\Visual Studio 2022\PARTS_Web\app\env_web\Lib\site-packages\pip\_internal\index\__init__.py", "Python", 0, 0, 0, -2, 0, 0, -1, -3
"c:\Users\edwar\OneDrive\Documents\Programming\Visual Studio 2022\PARTS_Web\app\env_web\Lib\site-packages\pip\_internal\index\collector.py", "Python", 0, 0, 0, -393, 0, -29, -86, -508
"c:\Users\edwar\OneDrive\Documents\Programming\Visual Studio 2022\PARTS_Web\app\env_web\Lib\site-packages\pip\_internal\index\package_finder.py", "Python", 0, 0, 0, -842, 0, -39, -147, -1028
"c:\Users\edwar\OneDrive\Documents\Programming\Visual Studio 2022\PARTS_Web\app\env_web\Lib\site-packages\pip\_internal\index\sources.py", "Python", 0, 0, 0, -224, 0, -3, -59, -286
"c:\Users\edwar\OneDrive\Documents\Programming\Visual Studio 2022\PARTS_Web\app\env_web\Lib\site-packages\pip\_internal\locations\__init__.py", "Python", 0, 0, 0, -345, 0, -37, -86, -468
"c:\Users\edwar\OneDrive\Documents\Programming\Visual Studio 2022\PARTS_Web\app\env_web\Lib\site-packages\pip\_internal\locations\_distutils.py", "Python", 0, 0, 0, -127, 0, -21, -25, -173
"c:\Users\edwar\OneDrive\Documents\Programming\Visual Studio 2022\PARTS_Web\app\env_web\Lib\site-packages\pip\_internal\locations\_sysconfig.py", "Python", 0, 0, 0, -158, 0, -17, -39, -214
"c:\Users\edwar\OneDrive\Documents\Programming\Visual Studio 2022\PARTS_Web\app\env_web\Lib\site-packages\pip\_internal\locations\base.py", "Python", 0, 0, 0, -55, 0, -8, -19, -82
"c:\Users\edwar\OneDrive\Documents\Programming\Visual Studio 2022\PARTS_Web\app\env_web\Lib\site-packages\pip\_internal\main.py", "Python", 0, 0, 0, -8, 0, 0, -5, -13
"c:\Users\edwar\OneDrive\Documents\Programming\Visual Studio 2022\PARTS_Web\app\env_web\Lib\site-packages\pip\_internal\metadata\__init__.py", "Python", 0, 0, 0, -96, 0, 0, -33, -129
"c:\Users\edwar\OneDrive\Documents\Programming\Visual Studio 2022\PARTS_Web\app\env_web\Lib\site-packages\pip\_internal\metadata\_json.py", "Python", 0, 0, 0, -68, 0, -6, -11, -85
"c:\Users\edwar\OneDrive\Documents\Programming\Visual Studio 2022\PARTS_Web\app\env_web\Lib\site-packages\pip\_internal\metadata\base.py", "Python", 0, 0, 0, -564, 0, -15, -124, -703
"c:\Users\edwar\OneDrive\Documents\Programming\Visual Studio 2022\PARTS_Web\app\env_web\Lib\site-packages\pip\_internal\metadata\importlib\__init__.py", "Python", 0, 0, 0, -4, 0, 0, -3, -7
"c:\Users\edwar\OneDrive\Documents\Programming\Visual Studio 2022\PARTS_Web\app\env_web\Lib\site-packages\pip\_internal\metadata\importlib\_compat.py", "Python", 0, 0, 0, -40, 0, 0, -16, -56
"c:\Users\edwar\OneDrive\Documents\Programming\Visual Studio 2022\PARTS_Web\app\env_web\Lib\site-packages\pip\_internal\metadata\importlib\_dists.py", "Python", 0, 0, 0, -184, 0, -12, -32, -228
"c:\Users\edwar\OneDrive\Documents\Programming\Visual Studio 2022\PARTS_Web\app\env_web\Lib\site-packages\pip\_internal\metadata\importlib\_envs.py", "Python", 0, 0, 0, -150, 0, -6, -34, -190
"c:\Users\edwar\OneDrive\Documents\Programming\Visual Studio 2022\PARTS_Web\app\env_web\Lib\site-packages\pip\_internal\metadata\pkg_resources.py", "Python", 0, 0, 0, -212, 0, -17, -50, -279
"c:\Users\edwar\OneDrive\Documents\Programming\Visual Studio 2022\PARTS_Web\app\env_web\Lib\site-packages\pip\_internal\models\__init__.py", "Python", 0, 0, 0, -2, 0, 0, -1, -3
"c:\Users\edwar\OneDrive\Documents\Programming\Visual Studio 2022\PARTS_Web\app\env_web\Lib\site-packages\pip\_internal\models\candidate.py", "Python", 0, 0, 0, -22, 0, 0, -9, -31
"c:\Users\edwar\OneDrive\Documents\Programming\Visual Studio 2022\PARTS_Web\app\env_web\Lib\site-packages\pip\_internal\models\direct_url.py", "Python", 0, 0, 0, -190, 0, -3, -43, -236
"c:\Users\edwar\OneDrive\Documents\Programming\Visual Studio 2022\PARTS_Web\app\env_web\Lib\site-packages\pip\_internal\models\format_control.py", "Python", 0, 0, 0, -63, 0, -1, -15, -79
"c:\Users\edwar\OneDrive\Documents\Programming\Visual Studio 2022\PARTS_Web\app\env_web\Lib\site-packages\pip\_internal\models\index.py", "Python", 0, 0, 0, -17, 0, -3, -9, -29
"c:\Users\edwar\OneDrive\Documents\Programming\Visual Studio 2022\PARTS_Web\app\env_web\Lib\site-packages\pip\_internal\models\installation_report.py", "Python", 0, 0, 0, -29, 0, -21, -7, -57
"c:\Users\edwar\OneDrive\Documents\Programming\Visual Studio 2022\PARTS_Web\app\env_web\Lib\site-packages\pip\_internal\models\link.py", "Python", 0, 0, 0, -427, 0, -54, -99, -580
"c:\Users\edwar\OneDrive\Documents\Programming\Visual Studio 2022\PARTS_Web\app\env_web\Lib\site-packages\pip\_internal\models\scheme.py", "Python", 0, 0, 0, -24, 0, 0, -8, -32
"c:\Users\edwar\OneDrive\Documents\Programming\Visual Studio 2022\PARTS_Web\app\env_web\Lib\site-packages\pip\_internal\models\search_scope.py", "Python", 0, 0, 0, -93, 0, -18, -22, -133
"c:\Users\edwar\OneDrive\Documents\Programming\Visual Studio 2022\PARTS_Web\app\env_web\Lib\site-packages\pip\_internal\models\selection_prefs.py", "Python", 0, 0, 0, -40, 0, -4, -8, -52
"c:\Users\edwar\OneDrive\Documents\Programming\Visual Studio 2022\PARTS_Web\app\env_web\Lib\site-packages\pip\_internal\models\target_python.py", "Python", 0, 0, 0, -98, 0, -4, -21, -123
"c:\Users\edwar\OneDrive\Documents\Programming\Visual Studio 2022\PARTS_Web\app\env_web\Lib\site-packages\pip\_internal\models\wheel.py", "Python", 0, 0, 0, -71, 0, -3, -19, -93
"c:\Users\edwar\OneDrive\Documents\Programming\Visual Studio 2022\PARTS_Web\app\env_web\Lib\site-packages\pip\_internal\network\__init__.py", "Python", 0, 0, 0, -2, 0, 0, -1, -3
"c:\Users\edwar\OneDrive\Documents\Programming\Visual Studio 2022\PARTS_Web\app\env_web\Lib\site-packages\pip\_internal\network\auth.py", "Python", 0, 0, 0, -387, 0, -71, -104, -562
"c:\Users\edwar\OneDrive\Documents\Programming\Visual Studio 2022\PARTS_Web\app\env_web\Lib\site-packages\pip\_internal\network\cache.py", "Python", 0, 0, 0, -80, 0, -5, -22, -107
"c:\Users\edwar\OneDrive\Documents\Programming\Visual Studio 2022\PARTS_Web\app\env_web\Lib\site-packages\pip\_internal\network\download.py", "Python", 0, 0, 0, -150, 0, -3, -34, -187
"c:\Users\edwar\OneDrive\Documents\Programming\Visual Studio 2022\PARTS_Web\app\env_web\Lib\site-packages\pip\_internal\network\lazy_wheel.py", "Python", 0, 0, 0, -166, 0, -7, -38, -211
"c:\Users\edwar\OneDrive\Documents\Programming\Visual Studio 2022\PARTS_Web\app\env_web\Lib\site-packages\pip\_internal\network\session.py", "Python", 0, 0, 0, -359, 0, -81, -81, -521
"c:\Users\edwar\OneDrive\Documents\Programming\Visual Studio 2022\PARTS_Web\app\env_web\Lib\site-packages\pip\_internal\network\utils.py", "Python", 0, 0, 0, -39, 0, -47, -11, -97
"c:\Users\edwar\OneDrive\Documents\Programming\Visual Studio 2022\PARTS_Web\app\env_web\Lib\site-packages\pip\_internal\network\xmlrpc.py", "Python", 0, 0, 0, -53, 0, 0, -10, -63
"c:\Users\edwar\OneDrive\Documents\Programming\Visual Studio 2022\PARTS_Web\app\env_web\Lib\site-packages\pip\_internal\operations\__init__.py", "Python", 0, 0, 0, 0, 0, 0, -1, -1
"c:\Users\edwar\OneDrive\Documents\Programming\Visual Studio 2022\PARTS_Web\app\env_web\Lib\site-packages\pip\_internal\operations\check.py", "Python", 0, 0, 0, -138, 0, -10, -40, -188
"c:\Users\edwar\OneDrive\Documents\Programming\Visual Studio 2022\PARTS_Web\app\env_web\Lib\site-packages\pip\_internal\operations\freeze.py", "Python", 0, 0, 0, -214, 0, -12, -30, -256
"c:\Users\edwar\OneDrive\Documents\Programming\Visual Studio 2022\PARTS_Web\app\env_web\Lib\site-packages\pip\_internal\operations\install\__init__.py", "Python", 0, 0, 0, -2, 0, 0, -1, -3
"c:\Users\edwar\OneDrive\Documents\Programming\Visual Studio 2022\PARTS_Web\app\env_web\Lib\site-packages\pip\_internal\operations\install\editable_legacy.py", "Python", 0, 0, 0, -40, 0, 0, -7, -47
"c:\Users\edwar\OneDrive\Documents\Programming\Visual Studio 2022\PARTS_Web\app\env_web\Lib\site-packages\pip\_internal\operations\install\wheel.py", "Python", 0, 0, 0, -523, 0, -94, -118, -735
"c:\Users\edwar\OneDrive\Documents\Programming\Visual Studio 2022\PARTS_Web\app\env_web\Lib\site-packages\pip\_internal\operations\prepare.py", "Python", 0, 0, 0, -529, 0, -113, -89, -731
"c:\Users\edwar\OneDrive\Documents\Programming\Visual Studio 2022\PARTS_Web\app\env_web\Lib\site-packages\pip\_internal\pyproject.py", "Python", 0, 0, 0, -106, 0, -45, -29, -180
"c:\Users\edwar\OneDrive\Documents\Programming\Visual Studio 2022\PARTS_Web\app\env_web\Lib\site-packages\pip\_internal\req\__init__.py", "Python", 0, 0, 0, -73, 0, -1, -19, -93
"c:\Users\edwar\OneDrive\Documents\Programming\Visual Studio 2022\PARTS_Web\app\env_web\Lib\site-packages\pip\_internal\req\constructors.py", "Python", 0, 0, 0, -474, 0, -24, -79, -577
"c:\Users\edwar\OneDrive\Documents\Programming\Visual Studio 2022\PARTS_Web\app\env_web\Lib\site-packages\pip\_internal\req\req_file.py", "Python", 0, 0, 0, -426, 0, -34, -95, -555
"c:\Users\edwar\OneDrive\Documents\Programming\Visual Studio 2022\PARTS_Web\app\env_web\Lib\site-packages\pip\_internal\req\req_install.py", "Python", 0, 0, 0, -738, 0, -77, -109, -924
"c:\Users\edwar\OneDrive\Documents\Programming\Visual Studio 2022\PARTS_Web\app\env_web\Lib\site-packages\pip\_internal\req\req_set.py", "Python", 0, 0, 0, -97, 0, 0, -23, -120
"c:\Users\edwar\OneDrive\Documents\Programming\Visual Studio 2022\PARTS_Web\app\env_web\Lib\site-packages\pip\_internal\req\req_uninstall.py", "Python", 0, 0, 0, -489, 0, -57, -104, -650
"c:\Users\edwar\OneDrive\Documents\Programming\Visual Studio 2022\PARTS_Web\app\env_web\Lib\site-packages\pip\_internal\resolution\__init__.py", "Python", 0, 0, 0, 0, 0, 0, -1, -1
"c:\Users\edwar\OneDrive\Documents\Programming\Visual Studio 2022\PARTS_Web\app\env_web\Lib\site-packages\pip\_internal\resolution\base.py", "Python", 0, 0, 0, -15, 0, 0, -6, -21
"c:\Users\edwar\OneDrive\Documents\Programming\Visual Studio 2022\PARTS_Web\app\env_web\Lib\site-packages\pip\_internal\resolution\legacy\__init__.py", "Python", 0, 0, 0, 0, 0, 0, -1, -1
"c:\Users\edwar\OneDrive\Documents\Programming\Visual Studio 2022\PARTS_Web\app\env_web\Lib\site-packages\pip\_internal\resolution\legacy\resolver.py", "Python", 0, 0, 0, -448, 0, -70, -81, -599
"c:\Users\edwar\OneDrive\Documents\Programming\Visual Studio 2022\PARTS_Web\app\env_web\Lib\site-packages\pip\_internal\resolution\resolvelib\__init__.py", "Python", 0, 0, 0, 0, 0, 0, -1, -1
"c:\Users\edwar\OneDrive\Documents\Programming\Visual Studio 2022\PARTS_Web\app\env_web\Lib\site-packages\pip\_internal\resolution\resolvelib\base.py", "Python", 0, 0, 0, -103, 0, -4, -35, -142
"c:\Users\edwar\OneDrive\Documents\Programming\Visual Studio 2022\PARTS_Web\app\env_web\Lib\site-packages\pip\_internal\resolution\resolvelib\candidates.py", "Python", 0, 0, 0, -470, 0, -29, -99, -598
"c:\Users\edwar\OneDrive\Documents\Programming\Visual Studio 2022\PARTS_Web\app\env_web\Lib\site-packages\pip\_internal\resolution\resolvelib\factory.py", "Python", 0, 0, 0, -656, 0, -77, -80, -813
"c:\Users\edwar\OneDrive\Documents\Programming\Visual Studio 2022\PARTS_Web\app\env_web\Lib\site-packages\pip\_internal\resolution\resolvelib\found_candidates.py", "Python", 0, 0, 0, -112, 0, -18, -26, -156
"c:\Users\edwar\OneDrive\Documents\Programming\Visual Studio 2022\PARTS_Web\app\env_web\Lib\site-packages\pip\_internal\resolution\resolvelib\provider.py", "Python", 0, 0, 0, -191, 0, -29, -36, -256
"c:\Users\edwar\OneDrive\Documents\Programming\Visual Studio 2022\PARTS_Web\app\env_web\Lib\site-packages\pip\_internal\resolution\resolvelib\reporter.py", "Python", 0, 0, 0, -60, 0, -1, -20, -81
"c:\Users\edwar\OneDrive\Documents\Programming\Visual Studio 2022\PARTS_Web\app\env_web\Lib\site-packages\pip\_internal\resolution\resolvelib\requirements.py", "Python", 0, 0, 0, -110, 0, -12, -45, -167
"c:\Users\edwar\OneDrive\Documents\Programming\Visual Studio 2022\PARTS_Web\app\env_web\Lib\site-packages\pip\_internal\resolution\resolvelib\resolver.py", "Python", 0, 0, 0, -238, 0, -34, -46, -318
"c:\Users\edwar\OneDrive\Documents\Programming\Visual Studio 2022\PARTS_Web\app\env_web\Lib\site-packages\pip\_internal\self_outdated_check.py", "Python", 0, 0, 0, -185, 0, -16, -48, -249
"c:\Users\edwar\OneDrive\Documents\Programming\Visual Studio 2022\PARTS_Web\app\env_web\Lib\site-packages\pip\_internal\utils\__init__.py", "Python", 0, 0, 0, 0, 0, 0, -1, -1
"c:\Users\edwar\OneDrive\Documents\Programming\Visual Studio 2022\PARTS_Web\app\env_web\Lib\site-packages\pip\_internal\utils\_jaraco_text.py", "Python", 0, 0, 0, -83, 0, 0, -27, -110
"c:\Users\edwar\OneDrive\Documents\Programming\Visual Studio 2022\PARTS_Web\app\env_web\Lib\site-packages\pip\_internal\utils\_log.py", "Python", 0, 0, 0, -23, 0, -2, -14, -39
"c:\Users\edwar\OneDrive\Documents\Programming\Visual Studio 2022\PARTS_Web\app\env_web\Lib\site-packages\pip\_internal\utils\appdirs.py", "Python", 0, 0, 0, -31, 0, -5, -17, -53
"c:\Users\edwar\OneDrive\Documents\Programming\Visual Studio 2022\PARTS_Web\app\env_web\Lib\site-packages\pip\_internal\utils\compat.py", "Python", 0, 0, 0, -36, 0, -9, -19, -64
"c:\Users\edwar\OneDrive\Documents\Programming\Visual Studio 2022\PARTS_Web\app\env_web\Lib\site-packages\pip\_internal\utils\compatibility_tags.py", "Python", 0, 0, 0, -121, 0, -16, -29, -166
"c:\Users\edwar\OneDrive\Documents\Programming\Visual Studio 2022\PARTS_Web\app\env_web\Lib\site-packages\pip\_internal\utils\datetime.py", "Python", 0, 0, 0, -7, 0, 0, -5, -12
"c:\Users\edwar\OneDrive\Documents\Programming\Visual Studio 2022\PARTS_Web\app\env_web\Lib\site-packages\pip\_internal\utils\deprecation.py", "Python", 0, 0, 0, -92, 0, -6, -23, -121
"c:\Users\edwar\OneDrive\Documents\Programming\Visual Studio 2022\PARTS_Web\app\env_web\Lib\site-packages\pip\_internal\utils\direct_url_helpers.py", "Python", 0, 0, 0, -71, 0, -9, -8, -88
"c:\Users\edwar\OneDrive\Documents\Programming\Visual Studio 2022\PARTS_Web\app\env_web\Lib\site-packages\pip\_internal\utils\egg_link.py", "Python", 0, 0, 0, -67, 0, 0, -14, -81
"c:\Users\edwar\OneDrive\Documents\Programming\Visual Studio 2022\PARTS_Web\app\env_web\Lib\site-packages\pip\_internal\utils\encoding.py", "Python", 0, 0, 0, -30, 0, -1, -6, -37
"c:\Users\edwar\OneDrive\Documents\Programming\Visual Studio 2022\PARTS_Web\app\env_web\Lib\site-packages\pip\_internal\utils\entrypoints.py", "Python", 0, 0, 0, -65, 0, -5, -15, -85
"c:\Users\edwar\OneDrive\Documents\Programming\Visual Studio 2022\PARTS_Web\app\env_web\Lib\site-packages\pip\_internal\utils\filesystem.py", "Python", 0, 0, 0, -104, 0, -18, -32, -154
"c:\Users\edwar\OneDrive\Documents\Programming\Visual Studio 2022\PARTS_Web\app\env_web\Lib\site-packages\pip\_internal\utils\filetypes.py", "Python", 0, 0, 0, -22, 0, 0, -6, -28
"c:\Users\edwar\OneDrive\Documents\Programming\Visual Studio 2022\PARTS_Web\app\env_web\Lib\site-packages\pip\_internal\utils\glibc.py", "Python", 0, 0, 0, -44, 0, -31, -14, -89
"c:\Users\edwar\OneDrive\Documents\Programming\Visual Studio 2022\PARTS_Web\app\env_web\Lib\site-packages\pip\_internal\utils\hashes.py", "Python", 0, 0, 0, -103, 0, -12, -37, -152
"c:\Users\edwar\OneDrive\Documents\Programming\Visual Studio 2022\PARTS_Web\app\env_web\Lib\site-packages\pip\_internal\utils\logging.py", "Python", 0, 0, 0, -273, 0, -22, -54, -349
"c:\Users\edwar\OneDrive\Documents\Programming\Visual Studio 2022\PARTS_Web\app\env_web\Lib\site-packages\pip\_internal\utils\misc.py", "Python", 0, 0, 0, -597, 0, -28, -159, -784
"c:\Users\edwar\OneDrive\Documents\Programming\Visual Studio 2022\PARTS_Web\app\env_web\Lib\site-packages\pip\_internal\utils\models.py", "Python", 0, 0, 0, -26, 0, 0, -14, -40
"c:\Users\edwar\OneDrive\Documents\Programming\Visual Studio 2022\PARTS_Web\app\env_web\Lib\site-packages\pip\_internal\utils\packaging.py", "Python", 0, 0, 0, -36, 0, -6, -16, -58
"c:\Users\edwar\OneDrive\Documents\Programming\Visual Studio 2022\PARTS_Web\app\env_web\Lib\site-packages\pip\_internal\utils\setuptools_build.py", "Python", 0, 0, 0, -106, 0, -16, -25, -147
"c:\Users\edwar\OneDrive\Documents\Programming\Visual Studio 2022\PARTS_Web\app\env_web\Lib\site-packages\pip\_internal\utils\subprocess.py", "Python", 0, 0, 0, -197, 0, -39, -25, -261
"c:\Users\edwar\OneDrive\Documents\Programming\Visual Studio 2022\PARTS_Web\app\env_web\Lib\site-packages\pip\_internal\utils\temp_dir.py", "Python", 0, 0, 0, -220, 0, -22, -55, -297
"c:\Users\edwar\OneDrive\Documents\Programming\Visual Studio 2022\PARTS_Web\app\env_web\Lib\site-packages\pip\_internal\utils\unpacking.py", "Python", 0, 0, 0, -215, 0, -14, -29, -258
"c:\Users\edwar\OneDrive\Documents\Programming\Visual Studio 2022\PARTS_Web\app\env_web\Lib\site-packages\pip\_internal\utils\urls.py", "Python", 0, 0, 0, -45, 0, -5, -13, -63
"c:\Users\edwar\OneDrive\Documents\Programming\Visual Studio 2022\PARTS_Web\app\env_web\Lib\site-packages\pip\_internal\utils\virtualenv.py", "Python", 0, 0, 0, -72, 0, -7, -26, -105
"c:\Users\edwar\OneDrive\Documents\Programming\Visual Studio 2022\PARTS_Web\app\env_web\Lib\site-packages\pip\_internal\utils\wheel.py", "Python", 0, 0, 0, -92, 0, -7, -36, -135
"c:\Users\edwar\OneDrive\Documents\Programming\Visual Studio 2022\PARTS_Web\app\env_web\Lib\site-packages\pip\_internal\vcs\__init__.py", "Python", 0, 0, 0, -11, 0, -4, -1, -16
"c:\Users\edwar\OneDrive\Documents\Programming\Visual Studio 2022\PARTS_Web\app\env_web\Lib\site-packages\pip\_internal\vcs\bazaar.py", "Python", 0, 0, 0, -94, 0, -3, -16, -113
"c:\Users\edwar\OneDrive\Documents\Programming\Visual Studio 2022\PARTS_Web\app\env_web\Lib\site-packages\pip\_internal\vcs\git.py", "Python", 0, 0, 0, -402, 0, -56, -69, -527
"c:\Users\edwar\OneDrive\Documents\Programming\Visual Studio 2022\PARTS_Web\app\env_web\Lib\site-packages\pip\_internal\vcs\mercurial.py", "Python", 0, 0, 0, -146, 0, -1, -17, -164
"c:\Users\edwar\OneDrive\Documents\Programming\Visual Studio 2022\PARTS_Web\app\env_web\Lib\site-packages\pip\_internal\vcs\subversion.py", "Python", 0, 0, 0, -237, 0, -40, -48, -325
"c:\Users\edwar\OneDrive\Documents\Programming\Visual Studio 2022\PARTS_Web\app\env_web\Lib\site-packages\pip\_internal\vcs\versioncontrol.py", "Python", 0, 0, 0, -570, 0, -23, -113, -706
"c:\Users\edwar\OneDrive\Documents\Programming\Visual Studio 2022\PARTS_Web\app\env_web\Lib\site-packages\pip\_internal\wheel_builder.py", "Python", 0, 0, 0, -290, 0, -19, -46, -355
"c:\Users\edwar\OneDrive\Documents\Programming\Visual Studio 2022\PARTS_Web\app\env_web\Lib\site-packages\pip\_vendor\__init__.py", "Python", 0, 0, 0, -85, 0, -26, -11, -122
"c:\Users\edwar\OneDrive\Documents\Programming\Visual Studio 2022\PARTS_Web\app\env_web\Lib\site-packages\pip\_vendor\cachecontrol\__init__.py", "Python", 0, 0, 0, -19, 0, -3, -7, -29
"c:\Users\edwar\OneDrive\Documents\Programming\Visual Studio 2022\PARTS_Web\app\env_web\Lib\site-packages\pip\_vendor\cachecontrol\_cmd.py", "Python", 0, 0, 0, -43, 0, -7, -21, -71
"c:\Users\edwar\OneDrive\Documents\Programming\Visual Studio 2022\PARTS_Web\app\env_web\Lib\site-packages\pip\_vendor\cachecontrol\adapter.py", "Python", 0, 0, 0, -114, 0, -20, -28, -162
"c:\Users\edwar\OneDrive\Documents\Programming\Visual Studio 2022\PARTS_Web\app\env_web\Lib\site-packages\pip\_vendor\cachecontrol\cache.py", "Python", 0, 0, 0, -51, 0, -3, -21, -75
"c:\Users\edwar\OneDrive\Documents\Programming\Visual Studio 2022\PARTS_Web\app\env_web\Lib\site-packages\pip\_vendor\cachecontrol\caches\__init__.py", "Python", 0, 0, 0, -3, 0, -3, -3, -9
"c:\Users\edwar\OneDrive\Documents\Programming\Visual Studio 2022\PARTS_Web\app\env_web\Lib\site-packages\pip\_vendor\cachecontrol\caches\file_cache.py", "Python", 0, 0, 0, -122, 0, -23, -37, -182
"c:\Users\edwar\OneDrive\Documents\Programming\Visual Studio 2022\PARTS_Web\app\env_web\Lib\site-packages\pip\_vendor\cachecontrol\caches\redis_cache.py", "Python", 0, 0, 0, -34, 0, -3, -12, -49
"c:\Users\edwar\OneDrive\Documents\Programming\Visual Studio 2022\PARTS_Web\app\env_web\Lib\site-packages\pip\_vendor\cachecontrol\controller.py", "Python", 0, 0, 0, -348, 0, -67, -80, -495
"c:\Users\edwar\OneDrive\Documents\Programming\Visual Studio 2022\PARTS_Web\app\env_web\Lib\site-packages\pip\_vendor\cachecontrol\filewrapper.py", "Python", 0, 0, 0, -68, 0, -29, -23, -120
"c:\Users\edwar\OneDrive\Documents\Programming\Visual Studio 2022\PARTS_Web\app\env_web\Lib\site-packages\pip\_vendor\cachecontrol\heuristics.py", "Python", 0, 0, 0, -114, 0, -3, -38, -155
"c:\Users\edwar\OneDrive\Documents\Programming\Visual Studio 2022\PARTS_Web\app\env_web\Lib\site-packages\pip\_vendor\cachecontrol\serialize.py", "Python", 0, 0, 0, -135, 0, -40, -32, -207
"c:\Users\edwar\OneDrive\Documents\Programming\Visual Studio 2022\PARTS_Web\app\env_web\Lib\site-packages\pip\_vendor\cachecontrol\wrapper.py", "Python", 0, 0, 0, -33, 0, -3, -8, -44
"c:\Users\edwar\OneDrive\Documents\Programming\Visual Studio 2022\PARTS_Web\app\env_web\Lib\site-packages\pip\_vendor\certifi\__init__.py", "Python", 0, 0, 0, -3, 0, 0, -2, -5
"c:\Users\edwar\OneDrive\Documents\Programming\Visual Studio 2022\PARTS_Web\app\env_web\Lib\site-packages\pip\_vendor\certifi\__main__.py", "Python", 0, 0, 0, -9, 0, 0, -4, -13
"c:\Users\edwar\OneDrive\Documents\Programming\Visual Studio 2022\PARTS_Web\app\env_web\Lib\site-packages\pip\_vendor\certifi\core.py", "Python", 0, 0, 0, -51, 0, -37, -21, -109
"c:\Users\edwar\OneDrive\Documents\Programming\Visual Studio 2022\PARTS_Web\app\env_web\Lib\site-packages\pip\_vendor\chardet\__init__.py", "Python", 0, 0, 0, -84, 0, -19, -13, -116
"c:\Users\edwar\OneDrive\Documents\Programming\Visual Studio 2022\PARTS_Web\app\env_web\Lib\site-packages\pip\_vendor\chardet\big5freq.py", "Python", 0, 0, 0, -340, 0, -43, -4, -387
"c:\Users\edwar\OneDrive\Documents\Programming\Visual Studio 2022\PARTS_Web\app\env_web\Lib\site-packages\pip\_vendor\chardet\big5prober.py", "Python", 0, 0, 0, -16, 0, -26, -6, -48
"c:\Users\edwar\OneDrive\Documents\Programming\Visual Studio 2022\PARTS_Web\app\env_web\Lib\site-packages\pip\_vendor\chardet\chardistribution.py", "Python", 0, 0, 0, -158, 0, -70, -34, -262
"c:\Users\edwar\OneDrive\Documents\Programming\Visual Studio 2022\PARTS_Web\app\env_web\Lib\site-packages\pip\_vendor\chardet\charsetgroupprober.py", "Python", 0, 0, 0, -71, 0, -26, -10, -107
"c:\Users\edwar\OneDrive\Documents\Programming\Visual Studio 2022\PARTS_Web\app\env_web\Lib\site-packages\pip\_vendor\chardet\charsetprober.py", "Python", 0, 0, 0, -80, 0, -43, -25, -148
"c:\Users\edwar\OneDrive\Documents\Programming\Visual Studio 2022\PARTS_Web\app\env_web\Lib\site-packages\pip\_vendor\chardet\cli\__init__.py", "Python", 0, 0, 0, 0, 0, 0, -1, -1
"c:\Users\edwar\OneDrive\Documents\Programming\Visual Studio 2022\PARTS_Web\app\env_web\Lib\site-packages\pip\_vendor\chardet\cli\chardetect.py", "Python", 0, 0, 0, -94, 0, -2, -17, -113
"c:\Users\edwar\OneDrive\Documents\Programming\Visual Studio 2022\PARTS_Web\app\env_web\Lib\site-packages\pip\_vendor\chardet\codingstatemachine.py", "Python", 0, 0, 0, -48, 0, -29, -14, -91
"c:\Users\edwar\OneDrive\Documents\Programming\Visual Studio 2022\PARTS_Web\app\env_web\Lib\site-packages\pip\_vendor\chardet\codingstatemachinedict.py", "Python", 0, 0, 0, -12, 0, -4, -4, -20
"c:\Users\edwar\OneDrive\Documents\Programming\Visual Studio 2022\PARTS_Web\app\env_web\Lib\site-packages\pip\_vendor\chardet\cp949prober.py", "Python", 0, 0, 0, -16, 0, -28, -6, -50
"c:\Users\edwar\OneDrive\Documents\Programming\Visual Studio 2022\PARTS_Web\app\env_web\Lib\site-packages\pip\_vendor\chardet\enums.py", "Python", 0, 0, 0, -63, 0, 0, -23, -86
"c:\Users\edwar\OneDrive\Documents\Programming\Visual Studio 2022\PARTS_Web\app\env_web\Lib\site-packages\pip\_vendor\chardet\escprober.py", "Python", 0, 0, 0, -65, 0, -26, -12, -103
"c:\Users\edwar\OneDrive\Documents\Programming\Visual Studio 2022\PARTS_Web\app\env_web\Lib\site-packages\pip\_vendor\chardet\escsm.py", "Python", 0, 0, 0, -210, 0, -34, -18, -262
"c:\Users\edwar\OneDrive\Documents\Programming\Visual Studio 2022\PARTS_Web\app\env_web\Lib\site-packages\pip\_vendor\chardet\eucjpprober.py", "Python", 0, 0, 0, -61, 0, -27, -15, -103
"c:\Users\edwar\OneDrive\Documents\Programming\Visual Studio 2022\PARTS_Web\app\env_web\Lib\site-packages\pip\_vendor\chardet\euckrfreq.py", "Python", 0, 0, 0, -151, 0, -40, -6, -197
"c:\Users\edwar\OneDrive\Documents\Programming\Visual Studio 2022\PARTS_Web\app\env_web\Lib\site-packages\pip\_vendor\chardet\euckrprober.py", "Python", 0, 0, 0, -16, 0, -26, -6, -48
"c:\Users\edwar\OneDrive\Documents\Programming\Visual Studio 2022\PARTS_Web\app\env_web\Lib\site-packages\pip\_vendor\chardet\euctwfreq.py", "Python", 0, 0, 0, -340, 0, -43, -6, -389
"c:\Users\edwar\OneDrive\Documents\Programming\Visual Studio 2022\PARTS_Web\app\env_web\Lib\site-packages\pip\_vendor\chardet\euctwprober.py", "Python", 0, 0, 0, -16, 0, -26, -6, -48
"c:\Users\edwar\OneDrive\Documents\Programming\Visual Studio 2022\PARTS_Web\app\env_web\Lib\site-packages\pip\_vendor\chardet\gb2312freq.py", "Python", 0, 0, 0, -239, 0, -40, -6, -285
"c:\Users\edwar\OneDrive\Documents\Programming\Visual Studio 2022\PARTS_Web\app\env_web\Lib\site-packages\pip\_vendor\chardet\gb2312prober.py", "Python", 0, 0, 0, -16, 0, -26, -6, -48
"c:\Users\edwar\OneDrive\Documents\Programming\Visual Studio 2022\PARTS_Web\app\env_web\Lib\site-packages\pip\_vendor\chardet\hebrewprober.py", "Python", 0, 0, 0, -103, 0, -186, -28, -317
"c:\Users\edwar\OneDrive\Documents\Programming\Visual Studio 2022\PARTS_Web\app\env_web\Lib\site-packages\pip\_vendor\chardet\jisfreq.py", "Python", 0, 0, 0, -277, 0, -43, -6, -326
"c:\Users\edwar\OneDrive\Documents\Programming\Visual Studio 2022\PARTS_Web\app\env_web\Lib\site-packages\pip\_vendor\chardet\johabfreq.py", "Python", 0, 0, 0, -2352, 0, -28, -3, -2383
"c:\Users\edwar\OneDrive\Documents\Programming\Visual Studio 2022\PARTS_Web\app\env_web\Lib\site-packages\pip\_vendor\chardet\johabprober.py", "Python", 0, 0, 0, -16, 0, -26, -6, -48
"c:\Users\edwar\OneDrive\Documents\Programming\Visual Studio 2022\PARTS_Web\app\env_web\Lib\site-packages\pip\_vendor\chardet\jpcntx.py", "Python", 0, 0, 0, -171, 0, -46, -22, -239
"c:\Users\edwar\OneDrive\Documents\Programming\Visual Studio 2022\PARTS_Web\app\env_web\Lib\site-packages\pip\_vendor\chardet\langbulgarianmodel.py", "Python", 0, 0, 0, -4632, 0, -10, -8, -4650
"c:\Users\edwar\OneDrive\Documents\Programming\Visual Studio 2022\PARTS_Web\app\env_web\Lib\site-packages\pip\_vendor\chardet\langgreekmodel.py", "Python", 0, 0, 0, -4380, 0, -10, -8, -4398
"c:\Users\edwar\OneDrive\Documents\Programming\Visual Studio 2022\PARTS_Web\app\env_web\Lib\site-packages\pip\_vendor\chardet\langhebrewmodel.py", "Python", 0, 0, 0, -4365, 0, -10, -6, -4381
"c:\Users\edwar\OneDrive\Documents\Programming\Visual Studio 2022\PARTS_Web\app\env_web\Lib\site-packages\pip\_vendor\chardet\langhungarianmodel.py", "Python", 0, 0, 0, -4632, 0, -10, -8, -4650
"c:\Users\edwar\OneDrive\Documents\Programming\Visual Studio 2022\PARTS_Web\app\env_web\Lib\site-packages\pip\_vendor\chardet\langrussianmodel.py", "Python", 0, 0, 0, -5700, 0, -10, -16, -5726
"c:\Users\edwar\OneDrive\Documents\Programming\Visual Studio 2022\PARTS_Web\app\env_web\Lib\site-packages\pip\_vendor\chardet\langthaimodel.py", "Python", 0, 0, 0, -4365, 0, -10, -6, -4381
"c:\Users\edwar\OneDrive\Documents\Programming\Visual Studio 2022\PARTS_Web\app\env_web\Lib\site-packages\pip\_vendor\chardet\langturkishmodel.py", "Python", 0, 0, 0, -4365, 0, -10, -6, -4381
"c:\Users\edwar\OneDrive\Documents\Programming\Visual Studio 2022\PARTS_Web\app\env_web\Lib\site-packages\pip\_vendor\chardet\latin1prober.py", "Python", 0, 0, 0, -96, 0, -36, -16, -148
"c:\Users\edwar\OneDrive\Documents\Programming\Visual Studio 2022\PARTS_Web\app\env_web\Lib\site-packages\pip\_vendor\chardet\macromanprober.py", "Python", 0, 0, 0, -99, 0, -45, -19, -163
"c:\Users\edwar\OneDrive\Documents\Programming\Visual Studio 2022\PARTS_Web\app\env_web\Lib\site-packages\pip\_vendor\chardet\mbcharsetprober.py", "Python", 0, 0, 0, -55, 0, -28, -13, -96
"c:\Users\edwar\OneDrive\Documents\Programming\Visual Studio 2022\PARTS_Web\app\env_web\Lib\site-packages\pip\_vendor\chardet\mbcsgroupprober.py", "Python", 0, 0, 0, -26, 0, -28, -4, -58
"c:\Users\edwar\OneDrive\Documents\Programming\Visual Studio 2022\PARTS_Web\app\env_web\Lib\site-packages\pip\_vendor\chardet\mbcssm.py", "Python", 0, 0, 0, -547, 0, -68, -47, -662
"c:\Users\edwar\OneDrive\Documents\Programming\Visual Studio 2022\PARTS_Web\app\env_web\Lib\site-packages\pip\_vendor\chardet\metadata\__init__.py", "Python", 0, 0, 0, 0, 0, 0, -1, -1
"c:\Users\edwar\OneDrive\Documents\Programming\Visual Studio 2022\PARTS_Web\app\env_web\Lib\site-packages\pip\_vendor\chardet\metadata\languages.py", "Python", 0, 0, 0, -308, 0, -34, -11, -353
"c:\Users\edwar\OneDrive\Documents\Programming\Visual Studio 2022\PARTS_Web\app\env_web\Lib\site-packages\pip\_vendor\chardet\resultdict.py", "Python", 0, 0, 0, -9, 0, -4, -4, -17
"c:\Users\edwar\OneDrive\Documents\Programming\Visual Studio 2022\PARTS_Web\app\env_web\Lib\site-packages\pip\_vendor\chardet\sbcharsetprober.py", "Python", 0, 0, 0, -108, 0, -40, -15, -163
"c:\Users\edwar\OneDrive\Documents\Programming\Visual Studio 2022\PARTS_Web\app\env_web\Lib\site-packages\pip\_vendor\chardet\sbcsgroupprober.py", "Python", 0, 0, 0, -45, 0, -39, -5, -89
"c:\Users\edwar\OneDrive\Documents\Programming\Visual Studio 2022\PARTS_Web\app\env_web\Lib\site-packages\pip\_vendor\chardet\sjisprober.py", "Python", 0, 0, 0, -65, 0, -26, -15, -106
"c:\Users\edwar\OneDrive\Documents\Programming\Visual Studio 2022\PARTS_Web\app\env_web\Lib\site-packages\pip\_vendor\chardet\universaldetector.py", "Python", 0, 0, 0, -265, 0, -63, -35, -363
"c:\Users\edwar\OneDrive\Documents\Programming\Visual Studio 2022\PARTS_Web\app\env_web\Lib\site-packages\pip\_vendor\chardet\utf1632prober.py", "Python", 0, 0, 0, -175, 0, -26, -25, -226
"c:\Users\edwar\OneDrive\Documents\Programming\Visual Studio 2022\PARTS_Web\app\env_web\Lib\site-packages\pip\_vendor\chardet\utf8prober.py", "Python", 0, 0, 0, -44, 0, -26, -13, -83
"c:\Users\edwar\OneDrive\Documents\Programming\Visual Studio 2022\PARTS_Web\app\env_web\Lib\site-packages\pip\_vendor\chardet\version.py", "Python", 0, 0, 0, -7, 0, 0, -3, -10
"c:\Users\edwar\OneDrive\Documents\Programming\Visual Studio 2022\PARTS_Web\app\env_web\Lib\site-packages\pip\_vendor\colorama\__init__.py", "Python", 0, 0, 0, -4, 0, -1, -3, -8
"c:\Users\edwar\OneDrive\Documents\Programming\Visual Studio 2022\PARTS_Web\app\env_web\Lib\site-packages\pip\_vendor\colorama\ansi.py", "Python", 0, 0, 0, -77, 0, -6, -20, -103
"c:\Users\edwar\OneDrive\Documents\Programming\Visual Studio 2022\PARTS_Web\app\env_web\Lib\site-packages\pip\_vendor\colorama\ansitowin32.py", "Python", 0, 0, 0, -209, 0, -25, -44, -278
"c:\Users\edwar\OneDrive\Documents\Programming\Visual Studio 2022\PARTS_Web\app\env_web\Lib\site-packages\pip\_vendor\colorama\initialise.py", "Python", 0, 0, 0, -83, 0, -8, -31, -122
"c:\Users\edwar\OneDrive\Documents\Programming\Visual Studio 2022\PARTS_Web\app\env_web\Lib\site-packages\pip\_vendor\colorama\tests\__init__.py", "Python", 0, 0, 0, 0, 0, -1, -1, -2
"c:\Users\edwar\OneDrive\Documents\Programming\Visual Studio 2022\PARTS_Web\app\env_web\Lib\site-packages\pip\_vendor\colorama\tests\ansi_test.py", "Python", 0, 0, 0, -55, 0, -5, -17, -77
"c:\Users\edwar\OneDrive\Documents\Programming\Visual Studio 2022\PARTS_Web\app\env_web\Lib\site-packages\pip\_vendor\colorama\tests\ansitowin32_test.py", "Python", 0, 0, 0, -243, 0, -8, -44, -295
"c:\Users\edwar\OneDrive\Documents\Programming\Visual Studio 2022\PARTS_Web\app\env_web\Lib\site-packages\pip\_vendor\colorama\tests\initialise_test.py", "Python", 0, 0, 0, -145, 0, -10, -35, -190
"c:\Users\edwar\OneDrive\Documents\Programming\Visual Studio 2022\PARTS_Web\app\env_web\Lib\site-packages\pip\_vendor\colorama\tests\isatty_test.py", "Python", 0, 0, 0, -43, 0, -1, -14, -58
"c:\Users\edwar\OneDrive\Documents\Programming\Visual Studio 2022\PARTS_Web\app\env_web\Lib\site-packages\pip\_vendor\colorama\tests\utils.py", "Python", 0, 0, 0, -41, 0, -1, -8, -50
"c:\Users\edwar\OneDrive\Documents\Programming\Visual Studio 2022\PARTS_Web\app\env_web\Lib\site-packages\pip\_vendor\colorama\tests\winterm_test.py", "Python", 0, 0, 0, -99, 0, -1, -32, -132
"c:\Users\edwar\OneDrive\Documents\Programming\Visual Studio 2022\PARTS_Web\app\env_web\Lib\site-packages\pip\_vendor\colorama\win32.py", "Python", 0, 0, 0, -146, 0, -10, -25, -181
"c:\Users\edwar\OneDrive\Documents\Programming\Visual Studio 2022\PARTS_Web\app\env_web\Lib\site-packages\pip\_vendor\colorama\winterm.py", "Python", 0, 0, 0, -143, 0, -29, -24, -196
"c:\Users\edwar\OneDrive\Documents\Programming\Visual Studio 2022\PARTS_Web\app\env_web\Lib\site-packages\pip\_vendor\distlib\__init__.py", "Python", 0, 0, 0, -16, 0, -6, -12, -34
"c:\Users\edwar\OneDrive\Documents\Programming\Visual Studio 2022\PARTS_Web\app\env_web\Lib\site-packages\pip\_vendor\distlib\compat.py", "Python", 0, 0, 0, -861, 0, -101, -177, -1139
"c:\Users\edwar\OneDrive\Documents\Programming\Visual Studio 2022\PARTS_Web\app\env_web\Lib\site-packages\pip\_vendor\distlib\database.py", "Python", 0, 0, 0, -1135, 0, -45, -180, -1360
"c:\Users\edwar\OneDrive\Documents\Programming\Visual Studio 2022\PARTS_Web\app\env_web\Lib\site-packages\pip\_vendor\distlib\index.py", "Python", 0, 0, 0, -445, 0, -19, -45, -509
"c:\Users\edwar\OneDrive\Documents\Programming\Visual Studio 2022\PARTS_Web\app\env_web\Lib\site-packages\pip\_vendor\distlib\locators.py", "Python", 0, 0, 0, -1107, 0, -77, -120, -1304
"c:\Users\edwar\OneDrive\Documents\Programming\Visual Studio 2022\PARTS_Web\app\env_web\Lib\site-packages\pip\_vendor\distlib\manifest.py", "Python", 0, 0, 0, -276, 0, -40, -69, -385
"c:\Users\edwar\OneDrive\Documents\Programming\Visual Studio 2022\PARTS_Web\app\env_web\Lib\site-packages\pip\_vendor\distlib\markers.py", "Python", 0, 0, 0, -129, 0, -9, -30, -168
"c:\Users\edwar\OneDrive\Documents\Programming\Visual Studio 2022\PARTS_Web\app\env_web\Lib\site-packages\pip\_vendor\distlib\metadata.py", "Python", 0, 0, 0, -840, 0, -74, -155, -1069
"c:\Users\edwar\OneDrive\Documents\Programming\Visual Studio 2022\PARTS_Web\app\env_web\Lib\site-packages\pip\_vendor\distlib\resources.py", "Python", 0, 0, 0, -280, 0, -15, -64, -359
"c:\Users\edwar\OneDrive\Documents\Programming\Visual Studio 2022\PARTS_Web\app\env_web\Lib\site-packages\pip\_vendor\distlib\scripts.py", "Python", 0, 0, 0, -359, 0, -48, -46, -453
"c:\Users\edwar\OneDrive\Documents\Programming\Visual Studio 2022\PARTS_Web\app\env_web\Lib\site-packages\pip\_vendor\distlib\util.py", "Python", 0, 0, 0, -1564, 0, -167, -295, -2026
"c:\Users\edwar\OneDrive\Documents\Programming\Visual Studio 2022\PARTS_Web\app\env_web\Lib\site-packages\pip\_vendor\distlib\version.py", "Python", 0, 0, 0, -533, 0, -86, -133, -752
"c:\Users\edwar\OneDrive\Documents\Programming\Visual Studio 2022\PARTS_Web\app\env_web\Lib\site-packages\pip\_vendor\distlib\wheel.py", "Python", 0, 0, 0, -902, 0, -81, -117, -1100
"c:\Users\edwar\OneDrive\Documents\Programming\Visual Studio 2022\PARTS_Web\app\env_web\Lib\site-packages\pip\_vendor\distro\__init__.py", "Python", 0, 0, 0, -52, 0, 0, -3, -55
"c:\Users\edwar\OneDrive\Documents\Programming\Visual Studio 2022\PARTS_Web\app\env_web\Lib\site-packages\pip\_vendor\distro\__main__.py", "Python", 0, 0, 0, -3, 0, 0, -2, -5
"c:\Users\edwar\OneDrive\Documents\Programming\Visual Studio 2022\PARTS_Web\app\env_web\Lib\site-packages\pip\_vendor\distro\distro.py", "Python", 0, 0, 0, -1035, 0, -90, -275, -1400
"c:\Users\edwar\OneDrive\Documents\Programming\Visual Studio 2022\PARTS_Web\app\env_web\Lib\site-packages\pip\_vendor\idna\__init__.py", "Python", 0, 0, 0, -43, 0, 0, -2, -45
"c:\Users\edwar\OneDrive\Documents\Programming\Visual Studio 2022\PARTS_Web\app\env_web\Lib\site-packages\pip\_vendor\idna\codec.py", "Python", 0, 0, 0, -84, 0, -4, -25, -113
"c:\Users\edwar\OneDrive\Documents\Programming\Visual Studio 2022\PARTS_Web\app\env_web\Lib\site-packages\pip\_vendor\idna\compat.py", "Python", 0, 0, 0, -9, 0, 0, -5, -14
"c:\Users\edwar\OneDrive\Documents\Programming\Visual Studio 2022\PARTS_Web\app\env_web\Lib\site-packages\pip\_vendor\idna\core.py", "Python", 0, 0, 0, -319, 0, -8, -74, -401
"c:\Users\edwar\OneDrive\Documents\Programming\Visual Studio 2022\PARTS_Web\app\env_web\Lib\site-packages\pip\_vendor\idna\idnadata.py", "Python", 0, 0, 0, -2149, 0, -1, -2, -2152
"c:\Users\edwar\OneDrive\Documents\Programming\Visual Studio 2022\PARTS_Web\app\env_web\Lib\site-packages\pip\_vendor\idna\intranges.py", "Python", 0, 0, 0, -42, 0, -3, -10, -55
"c:\Users\edwar\OneDrive\Documents\Programming\Visual Studio 2022\PARTS_Web\app\env_web\Lib\site-packages\pip\_vendor\idna\package_data.py", "Python", 0, 0, 0, -1, 0, 0, -2, -3
"c:\Users\edwar\OneDrive\Documents\Programming\Visual Studio 2022\PARTS_Web\app\env_web\Lib\site-packages\pip\_vendor\idna\uts46data.py", "Python", 0, 0, 0, -8511, 0, -2, -88, -8601
"c:\Users\edwar\OneDrive\Documents\Programming\Visual Studio 2022\PARTS_Web\app\env_web\Lib\site-packages\pip\_vendor\msgpack\__init__.py", "Python", 0, 0, 0, -38, 0, -2, -18, -58
"c:\Users\edwar\OneDrive\Documents\Programming\Visual Studio 2022\PARTS_Web\app\env_web\Lib\site-packages\pip\_vendor\msgpack\exceptions.py", "Python", 0, 0, 0, -28, 0, -2, -19, -49
"c:\Users\edwar\OneDrive\Documents\Programming\Visual Studio 2022\PARTS_Web\app\env_web\Lib\site-packages\pip\_vendor\msgpack\ext.py", "Python", 0, 0, 0, -149, 0, -4, -41, -194
"c:\Users\edwar\OneDrive\Documents\Programming\Visual Studio 2022\PARTS_Web\app\env_web\Lib\site-packages\pip\_vendor\msgpack\fallback.py", "Python", 0, 0, 0, -857, 0, -22, -132, -1011
"c:\Users\edwar\OneDrive\Documents\Programming\Visual Studio 2022\PARTS_Web\app\env_web\Lib\site-packages\pip\_vendor\packaging\__about__.py", "Python", 0, 0, 0, -18, 0, -3, -6, -27
"c:\Users\edwar\OneDrive\Documents\Programming\Visual Studio 2022\PARTS_Web\app\env_web\Lib\site-packages\pip\_vendor\packaging\__init__.py", "Python", 0, 0, 0, -20, 0, -3, -3, -26
"c:\Users\edwar\OneDrive\Documents\Programming\Visual Studio 2022\PARTS_Web\app\env_web\Lib\site-packages\pip\_vendor\packaging\_manylinux.py", "Python", 0, 0, 0, -212, 0, -51, -39, -302
"c:\Users\edwar\OneDrive\Documents\Programming\Visual Studio 2022\PARTS_Web\app\env_web\Lib\site-packages\pip\_vendor\packaging\_musllinux.py", "Python", 0, 0, 0, -107, 0, -4, -26, -137
"c:\Users\edwar\OneDrive\Documents\Programming\Visual Studio 2022\PARTS_Web\app\env_web\Lib\site-packages\pip\_vendor\packaging\_structures.py", "Python", 0, 0, 0, -36, 0, -3, -23, -62
"c:\Users\edwar\OneDrive\Documents\Programming\Visual Studio 2022\PARTS_Web\app\env_web\Lib\site-packages\pip\_vendor\packaging\markers.py", "Python", 0, 0, 0, -224, 0, -7, -74, -305
"c:\Users\edwar\OneDrive\Documents\Programming\Visual Studio 2022\PARTS_Web\app\env_web\Lib\site-packages\pip\_vendor\packaging\requirements.py", "Python", 0, 0, 0, -105, 0, -9, -33, -147
"c:\Users\edwar\OneDrive\Documents\Programming\Visual Studio 2022\PARTS_Web\app\env_web\Lib\site-packages\pip\_vendor\packaging\specifiers.py", "Python", 0, 0, 0, -490, 0, -156, -157, -803
"c:\Users\edwar\OneDrive\Documents\Programming\Visual Studio 2022\PARTS_Web\app\env_web\Lib\site-packages\pip\_vendor\packaging\tags.py", "Python", 0, 0, 0, -373, 0, -26, -89, -488
"c:\Users\edwar\OneDrive\Documents\Programming\Visual Studio 2022\PARTS_Web\app\env_web\Lib\site-packages\pip\_vendor\packaging\utils.py", "Python", 0, 0, 0, -91, 0, -16, -30, -137
"c:\Users\edwar\OneDrive\Documents\Programming\Visual Studio 2022\PARTS_Web\app\env_web\Lib\site-packages\pip\_vendor\packaging\version.py", "Python", 0, 0, 0, -334, 0, -58, -113, -505
"c:\Users\edwar\OneDrive\Documents\Programming\Visual Studio 2022\PARTS_Web\app\env_web\Lib\site-packages\pip\_vendor\pkg_resources\__init__.py", "Python", 0, 0, 0, -2548, 0, -154, -660, -3362
"c:\Users\edwar\OneDrive\Documents\Programming\Visual Studio 2022\PARTS_Web\app\env_web\Lib\site-packages\pip\_vendor\platformdirs\__init__.py", "Python", 0, 0, 0, -495, 0, 0, -72, -567
"c:\Users\edwar\OneDrive\Documents\Programming\Visual Studio 2022\PARTS_Web\app\env_web\Lib\site-packages\pip\_vendor\platformdirs\__main__.py", "Python", 0, 0, 0, -42, 0, 0, -12, -54
"c:\Users\edwar\OneDrive\Documents\Programming\Visual Studio 2022\PARTS_Web\app\env_web\Lib\site-packages\pip\_vendor\platformdirs\android.py", "Python", 0, 0, 0, -160, 0, -7, -44, -211
"c:\Users\edwar\OneDrive\Documents\Programming\Visual Studio 2022\PARTS_Web\app\env_web\Lib\site-packages\pip\_vendor\platformdirs\api.py", "Python", 0, 0, 0, -186, 0, 0, -38, -224
"c:\Users\edwar\OneDrive\Documents\Programming\Visual Studio 2022\PARTS_Web\app\env_web\Lib\site-packages\pip\_vendor\platformdirs\macos.py", "Python", 0, 0, 0, -71, 0, 0, -21, -92
"c:\Users\edwar\OneDrive\Documents\Programming\Visual Studio 2022\PARTS_Web\app\env_web\Lib\site-packages\pip\_vendor\platformdirs\unix.py", "Python", 0, 0, 0, -180, 0, -5, -39, -224
"c:\Users\edwar\OneDrive\Documents\Programming\Visual Studio 2022\PARTS_Web\app\env_web\Lib\site-packages\pip\_vendor\platformdirs\version.py", "Python", 0, 0, 0, -2, 0, -2, -1, -5
"c:\Users\edwar\OneDrive\Documents\Programming\Visual Studio 2022\PARTS_Web\app\env_web\Lib\site-packages\pip\_vendor\platformdirs\windows.py", "Python", 0, 0, 0, -206, 0, -4, -46, -256
"c:\Users\edwar\OneDrive\Documents\Programming\Visual Studio 2022\PARTS_Web\app\env_web\Lib\site-packages\pip\_vendor\pygments\__init__.py", "Python", 0, 0, 0, -65, 0, -2, -16, -83
"c:\Users\edwar\OneDrive\Documents\Programming\Visual Studio 2022\PARTS_Web\app\env_web\Lib\site-packages\pip\_vendor\pygments\__main__.py", "Python", 0, 0, 0, -13, 0, 0, -5, -18
"c:\Users\edwar\OneDrive\Documents\Programming\Visual Studio 2022\PARTS_Web\app\env_web\Lib\site-packages\pip\_vendor\pygments\cmdline.py", "Python", 0, 0, 0, -554, 0, -39, -76, -669
"c:\Users\edwar\OneDrive\Documents\Programming\Visual Studio 2022\PARTS_Web\app\env_web\Lib\site-packages\pip\_vendor\pygments\console.py", "Python", 0, 0, 0, -54, 0, 0, -17, -71
"c:\Users\edwar\OneDrive\Documents\Programming\Visual Studio 2022\PARTS_Web\app\env_web\Lib\site-packages\pip\_vendor\pygments\filter.py", "Python", 0, 0, 0, -55, 0, -1, -16, -72
"c:\Users\edwar\OneDrive\Documents\Programming\Visual Studio 2022\PARTS_Web\app\env_web\Lib\site-packages\pip\_vendor\pygments\filters\__init__.py", "Python", 0, 0, 0, -858, 0, -3, -80, -941
"c:\Users\edwar\OneDrive\Documents\Programming\Visual Studio 2022\PARTS_Web\app\env_web\Lib\site-packages\pip\_vendor\pygments\formatter.py", "Python", 0, 0, 0, -88, 0, -10, -27, -125
"c:\Users\edwar\OneDrive\Documents\Programming\Visual Studio 2022\PARTS_Web\app\env_web\Lib\site-packages\pip\_vendor\pygments\formatters\__init__.py", "Python", 0, 0, 0, -123, 0, -4, -32, -159
"c:\Users\edwar\OneDrive\Documents\Programming\Visual Studio 2022\PARTS_Web\app\env_web\Lib\site-packages\pip\_vendor\pygments\formatters\_mapping.py", "Python", 0, 0, 0, -20, 0, -2, -2, -24
"c:\Users\edwar\OneDrive\Documents\Programming\Visual Studio 2022\PARTS_Web\app\env_web\Lib\site-packages\pip\_vendor\pygments\formatters\bbcode.py", "Python", 0, 0, 0, -85, 0, -1, -23, -109
"c:\Users\edwar\OneDrive\Documents\Programming\Visual Studio 2022\PARTS_Web\app\env_web\Lib\site-packages\pip\_vendor\pygments\formatters\groff.py", "Python", 0, 0, 0, -128, 0, 0, -43, -171
"c:\Users\edwar\OneDrive\Documents\Programming\Visual Studio 2022\PARTS_Web\app\env_web\Lib\site-packages\pip\_vendor\pygments\formatters\html.py", "Python", 0, 0, 0, -789, 0, -23, -178, -990
"c:\Users\edwar\OneDrive\Documents\Programming\Visual Studio 2022\PARTS_Web\app\env_web\Lib\site-packages\pip\_vendor\pygments\formatters\img.py", "Python", 0, 0, 0, -520, 0, -22, -104, -646
"c:\Users\edwar\OneDrive\Documents\Programming\Visual Studio 2022\PARTS_Web\app\env_web\Lib\site-packages\pip\_vendor\pygments\formatters\irc.py", "Python", 0, 0, 0, -126, 0, -4, -25, -155
"c:\Users\edwar\OneDrive\Documents\Programming\Visual Studio 2022\PARTS_Web\app\env_web\Lib\site-packages\pip\_vendor\pygments\formatters\latex.py", "Python", 0, 0, 0, -405, 0, -45, -72, -522
"c:\Users\edwar\OneDrive\Documents\Programming\Visual Studio 2022\PARTS_Web\app\env_web\Lib\site-packages\pip\_vendor\pygments\formatters\other.py", "Python", 0, 0, 0, -129, 0, -3, -30, -162
"c:\Users\edwar\OneDrive\Documents\Programming\Visual Studio 2022\PARTS_Web\app\env_web\Lib\site-packages\pip\_vendor\pygments\formatters\pangomarkup.py", "Python", 0, 0, 0, -62, 0, 0, -22, -84
"c:\Users\edwar\OneDrive\Documents\Programming\Visual Studio 2022\PARTS_Web\app\env_web\Lib\site-packages\pip\_vendor\pygments\formatters\rtf.py", "Python", 0, 0, 0, -111, 0, -9, -27, -147
"c:\Users\edwar\OneDrive\Documents\Programming\Visual Studio 2022\PARTS_Web\app\env_web\Lib\site-packages\pip\_vendor\pygments\formatters\svg.py", "Python", 0, 0, 0, -156, 0, 0, -33, -189
"c:\Users\edwar\OneDrive\Documents\Programming\Visual Studio 2022\PARTS_Web\app\env_web\Lib\site-packages\pip\_vendor\pygments\formatters\terminal.py", "Python", 0, 0, 0, -97, 0, -5, -26, -128
"c:\Users\edwar\OneDrive\Documents\Programming\Visual Studio 2022\PARTS_Web\app\env_web\Lib\site-packages\pip\_vendor\pygments\formatters\terminal256.py", "Python", 0, 0, 0, -255, 0, -21, -63, -339
"c:\Users\edwar\OneDrive\Documents\Programming\Visual Studio 2022\PARTS_Web\app\env_web\Lib\site-packages\pip\_vendor\pygments\lexer.py", "Python", 0, 0, 0, -719, 0, -85, -140, -944
"c:\Users\edwar\OneDrive\Documents\Programming\Visual Studio 2022\PARTS_Web\app\env_web\Lib\site-packages\pip\_vendor\pygments\lexers\__init__.py", "Python", 0, 0, 0, -275, 0, -22, -66, -363
"c:\Users\edwar\OneDrive\Documents\Programming\Visual Studio 2022\PARTS_Web\app\env_web\Lib\site-packages\pip\_vendor\pygments\lexers\_mapping.py", "Python", 0, 0, 0, -556, 0, -2, -2, -560
"c:\Users\edwar\OneDrive\Documents\Programming\Visual Studio 2022\PARTS_Web\app\env_web\Lib\site-packages\pip\_vendor\pygments\lexers\python.py", "Python", 0, 0, 0, -1056, 0, -67, -76, -1199
"c:\Users\edwar\OneDrive\Documents\Programming\Visual Studio 2022\PARTS_Web\app\env_web\Lib\site-packages\pip\_vendor\pygments\modeline.py", "Python", 0, 0, 0, -32, 0, 0, -12, -44
"c:\Users\edwar\OneDrive\Documents\Programming\Visual Studio 2022\PARTS_Web\app\env_web\Lib\site-packages\pip\_vendor\pygments\plugin.py", "Python", 0, 0, 0, -61, 0, -4, -24, -89
"c:\Users\edwar\OneDrive\Documents\Programming\Visual Studio 2022\PARTS_Web\app\env_web\Lib\site-packages\pip\_vendor\pygments\regexopt.py", "Python", 0, 0, 0, -66, 0, -13, -13, -92
"c:\Users\edwar\OneDrive\Documents\Programming\Visual Studio 2022\PARTS_Web\app\env_web\Lib\site-packages\pip\_vendor\pygments\scanner.py", "Python", 0, 0, 0, -89, 0, 0, -16, -105
"c:\Users\edwar\OneDrive\Documents\Programming\Visual Studio 2022\PARTS_Web\app\env_web\Lib\site-packages\pip\_vendor\pygments\sphinxext.py", "Python", 0, 0, 0, -174, 0, 0, -44, -218
"c:\Users\edwar\OneDrive\Documents\Programming\Visual Studio 2022\PARTS_Web\app\env_web\Lib\site-packages\pip\_vendor\pygments\style.py", "Python", 0, 0, 0, -153, 0, -17, -28, -198
"c:\Users\edwar\OneDrive\Documents\Programming\Visual Studio 2022\PARTS_Web\app\env_web\Lib\site-packages\pip\_vendor\pygments\styles\__init__.py", "Python", 0, 0, 0, -90, 0, -3, -11, -104
"c:\Users\edwar\OneDrive\Documents\Programming\Visual Studio 2022\PARTS_Web\app\env_web\Lib\site-packages\pip\_vendor\pygments\token.py", "Python", 0, 0, 0, -164, 0, -12, -38, -214
"c:\Users\edwar\OneDrive\Documents\Programming\Visual Studio 2022\PARTS_Web\app\env_web\Lib\site-packages\pip\_vendor\pygments\unistring.py", "Python", 0, 0, 0, -94, 0, -6, -54, -154
"c:\Users\edwar\OneDrive\Documents\Programming\Visual Studio 2022\PARTS_Web\app\env_web\Lib\site-packages\pip\_vendor\pygments\util.py", "Python", 0, 0, 0, -269, 0, -5, -57, -331
"c:\Users\edwar\OneDrive\Documents\Programming\Visual Studio 2022\PARTS_Web\app\env_web\Lib\site-packages\pip\_vendor\pyparsing\__init__.py", "Python", 0, 0, 0, -268, 0, -26, -29, -323
"c:\Users\edwar\OneDrive\Documents\Programming\Visual Studio 2022\PARTS_Web\app\env_web\Lib\site-packages\pip\_vendor\pyparsing\actions.py", "Python", 0, 0, 0, -151, 0, -8, -59, -218
"c:\Users\edwar\OneDrive\Documents\Programming\Visual Studio 2022\PARTS_Web\app\env_web\Lib\site-packages\pip\_vendor\pyparsing\common.py", "Python", 0, 0, 0, -312, 0, -39, -82, -433
"c:\Users\edwar\OneDrive\Documents\Programming\Visual Studio 2022\PARTS_Web\app\env_web\Lib\site-packages\pip\_vendor\pyparsing\core.py", "Python", 0, 0, 0, -4805, 0, -271, -1040, -6116
"c:\Users\edwar\OneDrive\Documents\Programming\Visual Studio 2022\PARTS_Web\app\env_web\Lib\site-packages\pip\_vendor\pyparsing\diagram\__init__.py", "Python", 0, 0, 0, -517, 0, -59, -81, -657
"c:\Users\edwar\OneDrive\Documents\Programming\Visual Studio 2022\PARTS_Web\app\env_web\Lib\site-packages\pip\_vendor\pyparsing\exceptions.py", "Python", 0, 0, 0, -232, 0, -7, -61, -300
"c:\Users\edwar\OneDrive\Documents\Programming\Visual Studio 2022\PARTS_Web\app\env_web\Lib\site-packages\pip\_vendor\pyparsing\helpers.py", "Python", 0, 0, 0, -871, 0, -41, -189, -1101
"c:\Users\edwar\OneDrive\Documents\Programming\Visual Studio 2022\PARTS_Web\app\env_web\Lib\site-packages\pip\_vendor\pyparsing\results.py", "Python", 0, 0, 0, -642, 0, -26, -129, -797
"c:\Users\edwar\OneDrive\Documents\Programming\Visual Studio 2022\PARTS_Web\app\env_web\Lib\site-packages\pip\_vendor\pyparsing\testing.py", "Python", 0, 0, 0, -279, 0, -10, -43, -332
"c:\Users\edwar\OneDrive\Documents\Programming\Visual Studio 2022\PARTS_Web\app\env_web\Lib\site-packages\pip\_vendor\pyparsing\unicode.py", "Python", 0, 0, 0, -307, 0, -5, -50, -362
"c:\Users\edwar\OneDrive\Documents\Programming\Visual Studio 2022\PARTS_Web\app\env_web\Lib\site-packages\pip\_vendor\pyparsing\util.py", "Python", 0, 0, 0, -212, 0, -13, -60, -285
"c:\Users\edwar\OneDrive\Documents\Programming\Visual Studio 2022\PARTS_Web\app\env_web\Lib\site-packages\pip\_vendor\pyproject_hooks\__init__.py", "Python", 0, 0, 0, -21, 0, 0, -3, -24
"c:\Users\edwar\OneDrive\Documents\Programming\Visual Studio 2022\PARTS_Web\app\env_web\Lib\site-packages\pip\_vendor\pyproject_hooks\_compat.py", "Python", 0, 0, 0, -6, 0, 0, -3, -9
"c:\Users\edwar\OneDrive\Documents\Programming\Visual Studio 2022\PARTS_Web\app\env_web\Lib\site-packages\pip\_vendor\pyproject_hooks\_impl.py", "Python", 0, 0, 0, -258, 0, -4, -69, -331
"c:\Users\edwar\OneDrive\Documents\Programming\Visual Studio 2022\PARTS_Web\app\env_web\Lib\site-packages\pip\_vendor\pyproject_hooks\_in_process\__init__.py", "Python", 0, 0, 0, -14, 0, -1, -4, -19
"c:\Users\edwar\OneDrive\Documents\Programming\Visual Studio 2022\PARTS_Web\app\env_web\Lib\site-packages\pip\_vendor\pyproject_hooks\_in_process\_in_process.py", "Python", 0, 0, 0, -274, 0, -6, -74, -354
"c:\Users\edwar\OneDrive\Documents\Programming\Visual Studio 2022\PARTS_Web\app\env_web\Lib\site-packages\pip\_vendor\requests\__init__.py", "Python", 0, 0, 0, -128, 0, -21, -34, -183
"c:\Users\edwar\OneDrive\Documents\Programming\Visual Studio 2022\PARTS_Web\app\env_web\Lib\site-packages\pip\_vendor\requests\__version__.py", "Python", 0, 0, 0, -10, 0, -3, -2, -15
"c:\Users\edwar\OneDrive\Documents\Programming\Visual Studio 2022\PARTS_Web\app\env_web\Lib\site-packages\pip\_vendor\requests\_internal_utils.py", "Python", 0, 0, 0, -40, 0, 0, -11, -51
"c:\Users\edwar\OneDrive\Documents\Programming\Visual Studio 2022\PARTS_Web\app\env_web\Lib\site-packages\pip\_vendor\requests\adapters.py", "Python", 0, 0, 0, -432, 0, -13, -94, -539
"c:\Users\edwar\OneDrive\Documents\Programming\Visual Studio 2022\PARTS_Web\app\env_web\Lib\site-packages\pip\_vendor\requests\api.py", "Python", 0, 0, 0, -117, 0, -3, -38, -158
"c:\Users\edwar\OneDrive\Documents\Programming\Visual Studio 2022\PARTS_Web\app\env_web\Lib\site-packages\pip\_vendor\requests\auth.py", "Python", 0, 0, 0, -223, 0, -27, -66, -316
"c:\Users\edwar\OneDrive\Documents\Programming\Visual Studio 2022\PARTS_Web\app\env_web\Lib\site-packages\pip\_vendor\requests\certs.py", "Python", 0, 0, 0, -17, 0, -1, -7, -25
"c:\Users\edwar\OneDrive\Documents\Programming\Visual Studio 2022\PARTS_Web\app\env_web\Lib\site-packages\pip\_vendor\requests\compat.py", "Python", 0, 0, 0, -44, 0, -12, -12, -68
"c:\Users\edwar\OneDrive\Documents\Programming\Visual Studio 2022\PARTS_Web\app\env_web\Lib\site-packages\pip\_vendor\requests\cookies.py", "Python", 0, 0, 0, -439, 0, -12, -111, -562
"c:\Users\edwar\OneDrive\Documents\Programming\Visual Studio 2022\PARTS_Web\app\env_web\Lib\site-packages\pip\_vendor\requests\exceptions.py", "Python", 0, 0, 0, -82, 0, -1, -59, -142
"c:\Users\edwar\OneDrive\Documents\Programming\Visual Studio 2022\PARTS_Web\app\env_web\Lib\site-packages\pip\_vendor\requests\help.py", "Python", 0, 0, 0, -109, 0, 0, -23, -132
"c:\Users\edwar\OneDrive\Documents\Programming\Visual Studio 2022\PARTS_Web\app\env_web\Lib\site-packages\pip\_vendor\requests\hooks.py", "Python", 0, 0, 0, -23, 0, -1, -10, -34
"c:\Users\edwar\OneDrive\Documents\Programming\Visual Studio 2022\PARTS_Web\app\env_web\Lib\site-packages\pip\_vendor\requests\models.py", "Python", 0, 0, 0, -737, 0, -114, -184, -1035
"c:\Users\edwar\OneDrive\Documents\Programming\Visual Studio 2022\PARTS_Web\app\env_web\Lib\site-packages\pip\_vendor\requests\packages.py", "Python", 0, 0, 0, -8, 0, -5, -4, -17
"c:\Users\edwar\OneDrive\Documents\Programming\Visual Studio 2022\PARTS_Web\app\env_web\Lib\site-packages\pip\_vendor\requests\sessions.py", "Python", 0, 0, 0, -564, 0, -116, -154, -834
"c:\Users\edwar\OneDrive\Documents\Programming\Visual Studio 2022\PARTS_Web\app\env_web\Lib\site-packages\pip\_vendor\requests\status_codes.py", "Python", 0, 0, 0, -112, 0, -4, -13, -129
"c:\Users\edwar\OneDrive\Documents\Programming\Visual Studio 2022\PARTS_Web\app\env_web\Lib\site-packages\pip\_vendor\requests\structures.py", "Python", 0, 0, 0, -67, 0, -5, -28, -100
"c:\Users\edwar\OneDrive\Documents\Programming\Visual Studio 2022\PARTS_Web\app\env_web\Lib\site-packages\pip\_vendor\requests\utils.py", "Python", 0, 0, 0, -775, 0, -86, -234, -1095
"c:\Users\edwar\OneDrive\Documents\Programming\Visual Studio 2022\PARTS_Web\app\env_web\Lib\site-packages\pip\_vendor\resolvelib\__init__.py", "Python", 0, 0, 0, -23, 0, 0, -4, -27
"c:\Users\edwar\OneDrive\Documents\Programming\Visual Studio 2022\PARTS_Web\app\env_web\Lib\site-packages\pip\_vendor\resolvelib\compat\__init__.py", "Python", 0, 0, 0, 0, 0, 0, -1, -1
"c:\Users\edwar\OneDrive\Documents\Programming\Visual Studio 2022\PARTS_Web\app\env_web\Lib\site-packages\pip\_vendor\resolvelib\compat\collections_abc.py", "Python", 0, 0, 0, -5, 0, 0, -2, -7
"c:\Users\edwar\OneDrive\Documents\Programming\Visual Studio 2022\PARTS_Web\app\env_web\Lib\site-packages\pip\_vendor\resolvelib\providers.py", "Python", 0, 0, 0, -105, 0, 0, -29, -134
"c:\Users\edwar\OneDrive\Documents\Programming\Visual Studio 2022\PARTS_Web\app\env_web\Lib\site-packages\pip\_vendor\resolvelib\reporters.py", "Python", 0, 0, 0, -31, 0, 0, -13, -44
"c:\Users\edwar\OneDrive\Documents\Programming\Visual Studio 2022\PARTS_Web\app\env_web\Lib\site-packages\pip\_vendor\resolvelib\resolvers.py", "Python", 0, 0, 0, -417, 0, -33, -98, -548
"c:\Users\edwar\OneDrive\Documents\Programming\Visual Studio 2022\PARTS_Web\app\env_web\Lib\site-packages\pip\_vendor\resolvelib\structs.py", "Python", 0, 0, 0, -127, 0, 0, -44, -171
"c:\Users\edwar\OneDrive\Documents\Programming\Visual Studio 2022\PARTS_Web\app\env_web\Lib\site-packages\pip\_vendor\rich\__init__.py", "Python", 0, 0, 0, -142, 0, -3, -33, -178
"c:\Users\edwar\OneDrive\Documents\Programming\Visual Studio 2022\PARTS_Web\app\env_web\Lib\site-packages\pip\_vendor\rich\__main__.py", "Python", 0, 0, 0, -234, 0, -2, -39, -275
"c:\Users\edwar\OneDrive\Documents\Programming\Visual Studio 2022\PARTS_Web\app\env_web\Lib\site-packages\pip\_vendor\rich\_cell_widths.py", "Python", 0, 0, 0, -449, 0, -1, -2, -452
"c:\Users\edwar\OneDrive\Documents\Programming\Visual Studio 2022\PARTS_Web\app\env_web\Lib\site-packages\pip\_vendor\rich\_emoji_codes.py", "Python", 0, 0, 0, -3610, 0, 0, -1, -3611
"c:\Users\edwar\OneDrive\Documents\Programming\Visual Studio 2022\PARTS_Web\app\env_web\Lib\site-packages\pip\_vendor\rich\_emoji_replace.py", "Python", 0, 0, 0, -25, 0, 0, -8, -33
"c:\Users\edwar\OneDrive\Documents\Programming\Visual Studio 2022\PARTS_Web\app\env_web\Lib\site-packages\pip\_vendor\rich\_export_format.py", "Python", 0, 0, 0, -68, 0, 0, -9, -77
"c:\Users\edwar\OneDrive\Documents\Programming\Visual Studio 2022\PARTS_Web\app\env_web\Lib\site-packages\pip\_vendor\rich\_extension.py", "Python", 0, 0, 0, -6, 0, -1, -4, -11
"c:\Users\edwar\OneDrive\Documents\Programming\Visual Studio 2022\PARTS_Web\app\env_web\Lib\site-packages\pip\_vendor\rich\_fileno.py", "Python", 0, 0, 0, -16, 0, -3, -6, -25
"c:\Users\edwar\OneDrive\Documents\Programming\Visual Studio 2022\PARTS_Web\app\env_web\Lib\site-packages\pip\_vendor\rich\_inspect.py", "Python", 0, 0, 0, -227, 0, -4, -40, -271
"c:\Users\edwar\OneDrive\Documents\Programming\Visual Studio 2022\PARTS_Web\app\env_web\Lib\site-packages\pip\_vendor\rich\_log_render.py", "Python", 0, 0, 0, -81, 0, 0, -14, -95
"c:\Users\edwar\OneDrive\Documents\Programming\Visual Studio 2022\PARTS_Web\app\env_web\Lib\site-packages\pip\_vendor\rich\_loop.py", "Python", 0, 0, 0, -36, 0, 0, -8, -44
"c:\Users\edwar\OneDrive\Documents\Programming\Visual Studio 2022\PARTS_Web\app\env_web\Lib\site-packages\pip\_vendor\rich\_null_file.py", "Python", 0, 0, 0, -47, 0, 0, -23, -70
"c:\Users\edwar\OneDrive\Documents\Programming\Visual Studio 2022\PARTS_Web\app\env_web\Lib\site-packages\pip\_vendor\rich\_palettes.py", "Python", 0, 0, 0, -301, 0, -3, -6, -310
"c:\Users\edwar\OneDrive\Documents\Programming\Visual Studio 2022\PARTS_Web\app\env_web\Lib\site-packages\pip\_vendor\rich\_pick.py", "Python", 0, 0, 0, -13, 0, 0, -5, -18
"c:\Users\edwar\OneDrive\Documents\Programming\Visual Studio 2022\PARTS_Web\app\env_web\Lib\site-packages\pip\_vendor\rich\_ratio.py", "Python", 0, 0, 0, -122, 0, -12, -27, -161
"c:\Users\edwar\OneDrive\Documents\Programming\Visual Studio 2022\PARTS_Web\app\env_web\Lib\site-packages\pip\_vendor\rich\_spinners.py", "Python", 0, 0, 0, -481, 0, 0, -2, -483
"c:\Users\edwar\OneDrive\Documents\Programming\Visual Studio 2022\PARTS_Web\app\env_web\Lib\site-packages\pip\_vendor\rich\_stack.py", "Python", 0, 0, 0, -11, 0, 0, -6, -17
"c:\Users\edwar\OneDrive\Documents\Programming\Visual Studio 2022\PARTS_Web\app\env_web\Lib\site-packages\pip\_vendor\rich\_timer.py", "Python", 0, 0, 0, -14, 0, 0, -6, -20
"c:\Users\edwar\OneDrive\Documents\Programming\Visual Studio 2022\PARTS_Web\app\env_web\Lib\site-packages\pip\_vendor\rich\_win32_console.py", "Python", 0, 0, 0, -527, 0, -4, -132, -663
"c:\Users\edwar\OneDrive\Documents\Programming\Visual Studio 2022\PARTS_Web\app\env_web\Lib\site-packages\pip\_vendor\rich\_windows.py", "Python", 0, 0, 0, -55, 0, -1, -17, -73
"c:\Users\edwar\OneDrive\Documents\Programming\Visual Studio 2022\PARTS_Web\app\env_web\Lib\site-packages\pip\_vendor\rich\_windows_renderer.py", "Python", 0, 0, 0, -52, 0, 0, -5, -57
"c:\Users\edwar\OneDrive\Documents\Programming\Visual Studio 2022\PARTS_Web\app\env_web\Lib\site-packages\pip\_vendor\rich\_wrap.py", "Python", 0, 0, 0, -46, 0, 0, -11, -57
"c:\Users\edwar\OneDrive\Documents\Programming\Visual Studio 2022\PARTS_Web\app\env_web\Lib\site-packages\pip\_vendor\rich\abc.py", "Python", 0, 0, 0, -22, 0, 0, -12, -34
"c:\Users\edwar\OneDrive\Documents\Programming\Visual Studio 2022\PARTS_Web\app\env_web\Lib\site-packages\pip\_vendor\rich\align.py", "Python", 0, 0, 0, -270, 0, -4, -38, -312
"c:\Users\edwar\OneDrive\Documents\Programming\Visual Studio 2022\PARTS_Web\app\env_web\Lib\site-packages\pip\_vendor\rich\ansi.py", "Python", 0, 0, 0, -201, 0, -6, -34, -241
"c:\Users\edwar\OneDrive\Documents\Programming\Visual Studio 2022\PARTS_Web\app\env_web\Lib\site-packages\pip\_vendor\rich\bar.py", "Python", 0, 0, 0, -71, 0, -5, -19, -95
"c:\Users\edwar\OneDrive\Documents\Programming\Visual Studio 2022\PARTS_Web\app\env_web\Lib\site-packages\pip\_vendor\rich\box.py", "Python", 0, 0, 0, -418, 0, -11, -89, -518
"c:\Users\edwar\OneDrive\Documents\Programming\Visual Studio 2022\PARTS_Web\app\env_web\Lib\site-packages\pip\_vendor\rich\cells.py", "Python", 0, 0, 0, -117, 0, -4, -34, -155
"c:\Users\edwar\OneDrive\Documents\Programming\Visual Studio 2022\PARTS_Web\app\env_web\Lib\site-packages\pip\_vendor\rich\color.py", "Python", 0, 0, 0, -544, 0, -3, -76, -623
"c:\Users\edwar\OneDrive\Documents\Programming\Visual Studio 2022\PARTS_Web\app\env_web\Lib\site-packages\pip\_vendor\rich\color_triplet.py", "Python", 0, 0, 0, -30, 0, 0, -9, -39
"c:\Users\edwar\OneDrive\Documents\Programming\Visual Studio 2022\PARTS_Web\app\env_web\Lib\site-packages\pip\_vendor\rich\columns.py", "Python", 0, 0, 0, -166, 0, -1, -21, -188
"c:\Users\edwar\OneDrive\Documents\Programming\Visual Studio 2022\PARTS_Web\app\env_web\Lib\site-packages\pip\_vendor\rich\console.py", "Python", 0, 0, 0, -2244, 0, -19, -371, -2634
"c:\Users\edwar\OneDrive\Documents\Programming\Visual Studio 2022\PARTS_Web\app\env_web\Lib\site-packages\pip\_vendor\rich\constrain.py", "Python", 0, 0, 0, -29, 0, 0, -9, -38
"c:\Users\edwar\OneDrive\Documents\Programming\Visual Studio 2022\PARTS_Web\app\env_web\Lib\site-packages\pip\_vendor\rich\containers.py", "Python", 0, 0, 0, -139, 0, 0, -29, -168
"c:\Users\edwar\OneDrive\Documents\Programming\Visual Studio 2022\PARTS_Web\app\env_web\Lib\site-packages\pip\_vendor\rich\control.py", "Python", 0, 0, 0, -180, 0, -1, -45, -226
"c:\Users\edwar\OneDrive\Documents\Programming\Visual Studio 2022\PARTS_Web\app\env_web\Lib\site-packages\pip\_vendor\rich\default_styles.py", "Python", 0, 0, 0, -181, 0, 0, -10, -191
"c:\Users\edwar\OneDrive\Documents\Programming\Visual Studio 2022\PARTS_Web\app\env_web\Lib\site-packages\pip\_vendor\rich\diagnose.py", "Python", 0, 0, 0, -30, 0, 0, -8, -38
"c:\Users\edwar\OneDrive\Documents\Programming\Visual Studio 2022\PARTS_Web\app\env_web\Lib\site-packages\pip\_vendor\rich\emoji.py", "Python", 0, 0, 0, -70, 0, 0, -27, -97
"c:\Users\edwar\OneDrive\Documents\Programming\Visual Studio 2022\PARTS_Web\app\env_web\Lib\site-packages\pip\_vendor\rich\errors.py", "Python", 0, 0, 0, -18, 0, 0, -17, -35
"c:\Users\edwar\OneDrive\Documents\Programming\Visual Studio 2022\PARTS_Web\app\env_web\Lib\site-packages\pip\_vendor\rich\file_proxy.py", "Python", 0, 0, 0, -47, 0, 0, -11, -58
"c:\Users\edwar\OneDrive\Documents\Programming\Visual Studio 2022\PARTS_Web\app\env_web\Lib\site-packages\pip\_vendor\rich\filesize.py", "Python", 0, 0, 0, -70, 0, -1, -19, -90
"c:\Users\edwar\OneDrive\Documents\Programming\Visual Studio 2022\PARTS_Web\app\env_web\Lib\site-packages\pip\_vendor\rich\highlighter.py", "Python", 0, 0, 0, -151, 0, -37, -45, -233
"c:\Users\edwar\OneDrive\Documents\Programming\Visual Studio 2022\PARTS_Web\app\env_web\Lib\site-packages\pip\_vendor\rich\json.py", "Python", 0, 0, 0, -123, 0, 0, -18, -141
"c:\Users\edwar\OneDrive\Documents\Programming\Visual Studio 2022\PARTS_Web\app\env_web\Lib\site-packages\pip\_vendor\rich\jupyter.py", "Python", 0, 0, 0, -77, 0, -2, -23, -102
"c:\Users\edwar\OneDrive\Documents\Programming\Visual Studio 2022\PARTS_Web\app\env_web\Lib\site-packages\pip\_vendor\rich\layout.py", "Python", 0, 0, 0, -358, 0, 0, -86, -444
"c:\Users\edwar\OneDrive\Documents\Programming\Visual Studio 2022\PARTS_Web\app\env_web\Lib\site-packages\pip\_vendor\rich\live.py", "Python", 0, 0, 0, -321, 0, -6, -49, -376
"c:\Users\edwar\OneDrive\Documents\Programming\Visual Studio 2022\PARTS_Web\app\env_web\Lib\site-packages\pip\_vendor\rich\live_render.py", "Python", 0, 0, 0, -95, 0, 0, -19, -114
"c:\Users\edwar\OneDrive\Documents\Programming\Visual Studio 2022\PARTS_Web\app\env_web\Lib\site-packages\pip\_vendor\rich\logging.py", "Python", 0, 0, 0, -253, 0, -4, -33, -290
"c:\Users\edwar\OneDrive\Documents\Programming\Visual Studio 2022\PARTS_Web\app\env_web\Lib\site-packages\pip\_vendor\rich\markup.py", "Python", 0, 0, 0, -197, 0, -3, -47, -247
"c:\Users\edwar\OneDrive\Documents\Programming\Visual Studio 2022\PARTS_Web\app\env_web\Lib\site-packages\pip\_vendor\rich\measure.py", "Python", 0, 0, 0, -126, 0, 0, -26, -152
"c:\Users\edwar\OneDrive\Documents\Programming\Visual Studio 2022\PARTS_Web\app\env_web\Lib\site-packages\pip\_vendor\rich\padding.py", "Python", 0, 0, 0, -121, 0, 0, -21, -142
"c:\Users\edwar\OneDrive\Documents\Programming\Visual Studio 2022\PARTS_Web\app\env_web\Lib\site-packages\pip\_vendor\rich\pager.py", "Python", 0, 0, 0, -23, 0, 0, -12, -35
"c:\Users\edwar\OneDrive\Documents\Programming\Visual Studio 2022\PARTS_Web\app\env_web\Lib\site-packages\pip\_vendor\rich\palette.py", "Python", 0, 0, 0, -82, 0, -1, -18, -101
"c:\Users\edwar\OneDrive\Documents\Programming\Visual Studio 2022\PARTS_Web\app\env_web\Lib\site-packages\pip\_vendor\rich\panel.py", "Python", 0, 0, 0, -277, 0, 0, -32, -309
"c:\Users\edwar\OneDrive\Documents\Programming\Visual Studio 2022\PARTS_Web\app\env_web\Lib\site-packages\pip\_vendor\rich\pretty.py", "Python", 0, 0, 0, -862, 0, -15, -118, -995
"c:\Users\edwar\OneDrive\Documents\Programming\Visual Studio 2022\PARTS_Web\app\env_web\Lib\site-packages\pip\_vendor\rich\progress.py", "Python", 0, 0, 0, -1434, 0, -10, -259, -1703
"c:\Users\edwar\OneDrive\Documents\Programming\Visual Studio 2022\PARTS_Web\app\env_web\Lib\site-packages\pip\_vendor\rich\progress_bar.py", "Python", 0, 0, 0, -193, 0, -1, -31, -225
"c:\Users\edwar\OneDrive\Documents\Programming\Visual Studio 2022\PARTS_Web\app\env_web\Lib\site-packages\pip\_vendor\rich\prompt.py", "Python", 0, 0, 0, -295, 0, 0, -82, -377
"c:\Users\edwar\OneDrive\Documents\Programming\Visual Studio 2022\PARTS_Web\app\env_web\Lib\site-packages\pip\_vendor\rich\protocol.py", "Python", 0, 0, 0, -31, 0, -1, -11, -43
"c:\Users\edwar\OneDrive\Documents\Programming\Visual Studio 2022\PARTS_Web\app\env_web\Lib\site-packages\pip\_vendor\rich\region.py", "Python", 0, 0, 0, -7, 0, 0, -4, -11
"c:\Users\edwar\OneDrive\Documents\Programming\Visual Studio 2022\PARTS_Web\app\env_web\Lib\site-packages\pip\_vendor\rich\repr.py", "Python", 0, 0, 0, -116, 0, 0, -34, -150
"c:\Users\edwar\OneDrive\Documents\Programming\Visual Studio 2022\PARTS_Web\app\env_web\Lib\site-packages\pip\_vendor\rich\rule.py", "Python", 0, 0, 0, -109, 0, 0, -22, -131
"c:\Users\edwar\OneDrive\Documents\Programming\Visual Studio 2022\PARTS_Web\app\env_web\Lib\site-packages\pip\_vendor\rich\scope.py", "Python", 0, 0, 0, -73, 0, 0, -14, -87
"c:\Users\edwar\OneDrive\Documents\Programming\Visual Studio 2022\PARTS_Web\app\env_web\Lib\site-packages\pip\_vendor\rich\screen.py", "Python", 0, 0, 0, -44, 0, 0, -11, -55
"c:\Users\edwar\OneDrive\Documents\Programming\Visual Studio 2022\PARTS_Web\app\env_web\Lib\site-packages\pip\_vendor\rich\segment.py", "Python", 0, 0, 0, -624, 0, -1, -115, -740
"c:\Users\edwar\OneDrive\Documents\Programming\Visual Studio 2022\PARTS_Web\app\env_web\Lib\site-packages\pip\_vendor\rich\spinner.py", "Python", 0, 0, 0, -115, 0, 0, -23, -138
"c:\Users\edwar\OneDrive\Documents\Programming\Visual Studio 2022\PARTS_Web\app\env_web\Lib\site-packages\pip\_vendor\rich\status.py", "Python", 0, 0, 0, -113, 0, 0, -20, -133
"c:\Users\edwar\OneDrive\Documents\Programming\Visual Studio 2022\PARTS_Web\app\env_web\Lib\site-packages\pip\_vendor\rich\style.py", "Python", 0, 0, 0, -696, 0, -2, -99, -797
"c:\Users\edwar\OneDrive\Documents\Programming\Visual Studio 2022\PARTS_Web\app\env_web\Lib\site-packages\pip\_vendor\rich\styled.py", "Python", 0, 0, 0, -31, 0, 0, -12, -43
"c:\Users\edwar\OneDrive\Documents\Programming\Visual Studio 2022\PARTS_Web\app\env_web\Lib\site-packages\pip\_vendor\rich\syntax.py", "Python", 0, 0, 0, -831, 0, -13, -105, -949
"c:\Users\edwar\OneDrive\Documents\Programming\Visual Studio 2022\PARTS_Web\app\env_web\Lib\site-packages\pip\_vendor\rich\table.py", "Python", 0, 0, 0, -878, 0, -4, -121, -1003
"c:\Users\edwar\OneDrive\Documents\Programming\Visual Studio 2022\PARTS_Web\app\env_web\Lib\site-packages\pip\_vendor\rich\terminal_theme.py", "Python", 0, 0, 0, -143, 0, 0, -11, -154
"c:\Users\edwar\OneDrive\Documents\Programming\Visual Studio 2022\PARTS_Web\app\env_web\Lib\site-packages\pip\_vendor\rich\text.py", "Python", 0, 0, 0, -1117, 0, -5, -186, -1308
"c:\Users\edwar\OneDrive\Documents\Programming\Visual Studio 2022\PARTS_Web\app\env_web\Lib\site-packages\pip\_vendor\rich\theme.py", "Python", 0, 0, 0, -91, 0, 0, -25, -116
"c:\Users\edwar\OneDrive\Documents\Programming\Visual Studio 2022\PARTS_Web\app\env_web\Lib\site-packages\pip\_vendor\rich\themes.py", "Python", 0, 0, 0, -3, 0, 0, -3, -6
"c:\Users\edwar\OneDrive\Documents\Programming\Visual Studio 2022\PARTS_Web\app\env_web\Lib\site-packages\pip\_vendor\rich\traceback.py", "Python", 0, 0, 0, -656, 0, -16, -85, -757
"c:\Users\edwar\OneDrive\Documents\Programming\Visual Studio 2022\PARTS_Web\app\env_web\Lib\site-packages\pip\_vendor\rich\tree.py", "Python", 0, 0, 0, -215, 0, -1, -36, -252
"c:\Users\edwar\OneDrive\Documents\Programming\Visual Studio 2022\PARTS_Web\app\env_web\Lib\site-packages\pip\_vendor\six.py", "Python", 0, 0, 0, -755, 0, -53, -191, -999
"c:\Users\edwar\OneDrive\Documents\Programming\Visual Studio 2022\PARTS_Web\app\env_web\Lib\site-packages\pip\_vendor\tenacity\__init__.py", "Python", 0, 0, 0, -461, 0, -41, -107, -609
"c:\Users\edwar\OneDrive\Documents\Programming\Visual Studio 2022\PARTS_Web\app\env_web\Lib\site-packages\pip\_vendor\tenacity\_asyncio.py", "Python", 0, 0, 0, -61, 0, -18, -16, -95
"c:\Users\edwar\OneDrive\Documents\Programming\Visual Studio 2022\PARTS_Web\app\env_web\Lib\site-packages\pip\_vendor\tenacity\_utils.py", "Python", 0, 0, 0, -43, 0, -19, -15, -77
"c:\Users\edwar\OneDrive\Documents\Programming\Visual Studio 2022\PARTS_Web\app\env_web\Lib\site-packages\pip\_vendor\tenacity\after.py", "Python", 0, 0, 0, -25, 0, -16, -11, -52
"c:\Users\edwar\OneDrive\Documents\Programming\Visual Studio 2022\PARTS_Web\app\env_web\Lib\site-packages\pip\_vendor\tenacity\before.py", "Python", 0, 0, 0, -20, 0, -16, -11, -47
"c:\Users\edwar\OneDrive\Documents\Programming\Visual Studio 2022\PARTS_Web\app\env_web\Lib\site-packages\pip\_vendor\tenacity\before_sleep.py", "Python", 0, 0, 0, -39, 0, -16, -17, -72
"c:\Users\edwar\OneDrive\Documents\Programming\Visual Studio 2022\PARTS_Web\app\env_web\Lib\site-packages\pip\_vendor\tenacity\nap.py", "Python", 0, 0, 0, -16, 0, -18, -10, -44
"c:\Users\edwar\OneDrive\Documents\Programming\Visual Studio 2022\PARTS_Web\app\env_web\Lib\site-packages\pip\_vendor\tenacity\retry.py", "Python", 0, 0, 0, -178, 0, -18, -77, -273
"c:\Users\edwar\OneDrive\Documents\Programming\Visual Studio 2022\PARTS_Web\app\env_web\Lib\site-packages\pip\_vendor\tenacity\stop.py", "Python", 0, 0, 0, -53, 0, -15, -36, -104
"c:\Users\edwar\OneDrive\Documents\Programming\Visual Studio 2022\PARTS_Web\app\env_web\Lib\site-packages\pip\_vendor\tenacity\tornadoweb.py", "Python", 0, 0, 0, -37, 0, -13, -10, -60
"c:\Users\edwar\OneDrive\Documents\Programming\Visual Studio 2022\PARTS_Web\app\env_web\Lib\site-packages\pip\_vendor\tenacity\wait.py", "Python", 0, 0, 0, -152, 0, -16, -61, -229
"c:\Users\edwar\OneDrive\Documents\Programming\Visual Studio 2022\PARTS_Web\app\env_web\Lib\site-packages\pip\_vendor\tomli\__init__.py", "Python", 0, 0, 0, -4, 0, -4, -4, -12
"c:\Users\edwar\OneDrive\Documents\Programming\Visual Studio 2022\PARTS_Web\app\env_web\Lib\site-packages\pip\_vendor\tomli\_parser.py", "Python", 0, 0, 0, -534, 0, -46, -112, -692
"c:\Users\edwar\OneDrive\Documents\Programming\Visual Studio 2022\PARTS_Web\app\env_web\Lib\site-packages\pip\_vendor\tomli\_re.py", "Python", 0, 0, 0, -87, 0, -6, -15, -108
"c:\Users\edwar\OneDrive\Documents\Programming\Visual Studio 2022\PARTS_Web\app\env_web\Lib\site-packages\pip\_vendor\tomli\_types.py", "Python", 0, 0, 0, -4, 0, -4, -3, -11
"c:\Users\edwar\OneDrive\Documents\Programming\Visual Studio 2022\PARTS_Web\app\env_web\Lib\site-packages\pip\_vendor\truststore\__init__.py", "Python", 0, 0, 0, -8, 0, 0, -6, -14
"c:\Users\edwar\OneDrive\Documents\Programming\Visual Studio 2022\PARTS_Web\app\env_web\Lib\site-packages\pip\_vendor\truststore\_api.py", "Python", 0, 0, 0, -231, 0, -15, -57, -303
"c:\Users\edwar\OneDrive\Documents\Programming\Visual Studio 2022\PARTS_Web\app\env_web\Lib\site-packages\pip\_vendor\truststore\_macos.py", "Python", 0, 0, 0, -386, 0, -33, -83, -502
"c:\Users\edwar\OneDrive\Documents\Programming\Visual Studio 2022\PARTS_Web\app\env_web\Lib\site-packages\pip\_vendor\truststore\_openssl.py", "Python", 0, 0, 0, -37, 0, -20, -10, -67
"c:\Users\edwar\OneDrive\Documents\Programming\Visual Studio 2022\PARTS_Web\app\env_web\Lib\site-packages\pip\_vendor\truststore\_ssl_constants.py", "Python", 0, 0, 0, -17, 0, -7, -8, -32
"c:\Users\edwar\OneDrive\Documents\Programming\Visual Studio 2022\PARTS_Web\app\env_web\Lib\site-packages\pip\_vendor\truststore\_windows.py", "Python", 0, 0, 0, -451, 0, -22, -82, -555
"c:\Users\edwar\OneDrive\Documents\Programming\Visual Studio 2022\PARTS_Web\app\env_web\Lib\site-packages\pip\_vendor\typing_extensions.py", "Python", 0, 0, 0, -2304, 0, -194, -575, -3073
"c:\Users\edwar\OneDrive\Documents\Programming\Visual Studio 2022\PARTS_Web\app\env_web\Lib\site-packages\pip\_vendor\urllib3\__init__.py", "Python", 0, 0, 0, -72, 0, -15, -16, -103
"c:\Users\edwar\OneDrive\Documents\Programming\Visual Studio 2022\PARTS_Web\app\env_web\Lib\site-packages\pip\_vendor\urllib3\_collections.py", "Python", 0, 0, 0, -252, 0, -19, -67, -338
"c:\Users\edwar\OneDrive\Documents\Programming\Visual Studio 2022\PARTS_Web\app\env_web\Lib\site-packages\pip\_vendor\urllib3\_version.py", "Python", 0, 0, 0, -1, 0, -1, -1, -3
"c:\Users\edwar\OneDrive\Documents\Programming\Visual Studio 2022\PARTS_Web\app\env_web\Lib\site-packages\pip\_vendor\urllib3\connection.py", "Python", 0, 0, 0, -422, 0, -54, -97, -573
"c:\Users\edwar\OneDrive\Documents\Programming\Visual Studio 2022\PARTS_Web\app\env_web\Lib\site-packages\pip\_vendor\urllib3\connectionpool.py", "Python", 0, 0, 0, -835, 0, -115, -183, -1133
"c:\Users\edwar\OneDrive\Documents\Programming\Visual Studio 2022\PARTS_Web\app\env_web\Lib\site-packages\pip\_vendor\urllib3\contrib\__init__.py", "Python", 0, 0, 0, 0, 0, 0, -1, -1
"c:\Users\edwar\OneDrive\Documents\Programming\Visual Studio 2022\PARTS_Web\app\env_web\Lib\site-packages\pip\_vendor\urllib3\contrib\_appengine_environ.py", "Python", 0, 0, 0, -24, 0, 0, -13, -37
"c:\Users\edwar\OneDrive\Documents\Programming\Visual Studio 2022\PARTS_Web\app\env_web\Lib\site-packages\pip\_vendor\urllib3\contrib\_securetransport\__init__.py", "Python", 0, 0, 0, 0, 0, 0, -1, -1
"c:\Users\edwar\OneDrive\Documents\Programming\Visual Studio 2022\PARTS_Web\app\env_web\Lib\site-packages\pip\_vendor\urllib3\contrib\_securetransport\bindings.py", "Python", 0, 0, 0, -414, 0, -9, -97, -520
"c:\Users\edwar\OneDrive\Documents\Programming\Visual Studio 2022\PARTS_Web\app\env_web\Lib\site-packages\pip\_vendor\urllib3\contrib\_securetransport\low_level.py", "Python", 0, 0, 0, -285, 0, -51, -62, -398
"c:\Users\edwar\OneDrive\Documents\Programming\Visual Studio 2022\PARTS_Web\app\env_web\Lib\site-packages\pip\_vendor\urllib3\contrib\appengine.py", "Python", 0, 0, 0, -244, 0, -14, -57, -315
"c:\Users\edwar\OneDrive\Documents\Programming\Visual Studio 2022\PARTS_Web\app\env_web\Lib\site-packages\pip\_vendor\urllib3\contrib\ntlmpool.py", "Python", 0, 0, 0, -104, 0, -7, -20, -131
"c:\Users\edwar\OneDrive\Documents\Programming\Visual Studio 2022\PARTS_Web\app\env_web\Lib\site-packages\pip\_vendor\urllib3\contrib\pyopenssl.py", "Python", 0, 0, 0, -389, 0, -25, -105, -519
"c:\Users\edwar\OneDrive\Documents\Programming\Visual Studio 2022\PARTS_Web\app\env_web\Lib\site-packages\pip\_vendor\urllib3\contrib\securetransport.py", "Python", 0, 0, 0, -646, 0, -134, -142, -922
"c:\Users\edwar\OneDrive\Documents\Programming\Visual Studio 2022\PARTS_Web\app\env_web\Lib\site-packages\pip\_vendor\urllib3\contrib\socks.py", "Python", 0, 0, 0, -167, 0, -7, -43, -217
"c:\Users\edwar\OneDrive\Documents\Programming\Visual Studio 2022\PARTS_Web\app\env_web\Lib\site-packages\pip\_vendor\urllib3\exceptions.py", "Python", 0, 0, 0, -183, 0, -10, -131, -324
"c:\Users\edwar\OneDrive\Documents\Programming\Visual Studio 2022\PARTS_Web\app\env_web\Lib\site-packages\pip\_vendor\urllib3\fields.py", "Python", 0, 0, 0, -212, 0, -5, -58, -275
"c:\Users\edwar\OneDrive\Documents\Programming\Visual Studio 2022\PARTS_Web\app\env_web\Lib\site-packages\pip\_vendor\urllib3\filepost.py", "Python", 0, 0, 0, -70, 0, 0, -29, -99
"c:\Users\edwar\OneDrive\Documents\Programming\Visual Studio 2022\PARTS_Web\app\env_web\Lib\site-packages\pip\_vendor\urllib3\packages\__init__.py", "Python", 0, 0, 0, 0, 0, 0, -1, -1
"c:\Users\edwar\OneDrive\Documents\Programming\Visual Studio 2022\PARTS_Web\app\env_web\Lib\site-packages\pip\_vendor\urllib3\packages\backports\__init__.py", "Python", 0, 0, 0, 0, 0, 0, -1, -1
"c:\Users\edwar\OneDrive\Documents\Programming\Visual Studio 2022\PARTS_Web\app\env_web\Lib\site-packages\pip\_vendor\urllib3\packages\backports\makefile.py", "Python", 0, 0, 0, -47, 0, -1, -4, -52
"c:\Users\edwar\OneDrive\Documents\Programming\Visual Studio 2022\PARTS_Web\app\env_web\Lib\site-packages\pip\_vendor\urllib3\packages\backports\weakref_finalize.py", "Python", 0, 0, 0, -120, 0, -15, -21, -156
"c:\Users\edwar\OneDrive\Documents\Programming\Visual Studio 2022\PARTS_Web\app\env_web\Lib\site-packages\pip\_vendor\urllib3\packages\six.py", "Python", 0, 0, 0, -805, 0, -53, -219, -1077
"c:\Users\edwar\OneDrive\Documents\Programming\Visual Studio 2022\PARTS_Web\app\env_web\Lib\site-packages\pip\_vendor\urllib3\poolmanager.py", "Python", 0, 0, 0, -402, 0, -33, -103, -538
"c:\Users\edwar\OneDrive\Documents\Programming\Visual Studio 2022\PARTS_Web\app\env_web\Lib\site-packages\pip\_vendor\urllib3\request.py", "Python", 0, 0, 0, -151, 0, 0, -41, -192
"c:\Users\edwar\OneDrive\Documents\Programming\Visual Studio 2022\PARTS_Web\app\env_web\Lib\site-packages\pip\_vendor\urllib3\response.py", "Python", 0, 0, 0, -669, 0, -79, -132, -880
"c:\Users\edwar\OneDrive\Documents\Programming\Visual Studio 2022\PARTS_Web\app\env_web\Lib\site-packages\pip\_vendor\urllib3\util\__init__.py", "Python", 0, 0, 0, -46, 0, -1, -3, -50
"c:\Users\edwar\OneDrive\Documents\Programming\Visual Studio 2022\PARTS_Web\app\env_web\Lib\site-packages\pip\_vendor\urllib3\util\connection.py", "Python", 0, 0, 0, -100, 0, -18, -32, -150
"c:\Users\edwar\OneDrive\Documents\Programming\Visual Studio 2022\PARTS_Web\app\env_web\Lib\site-packages\pip\_vendor\urllib3\util\proxy.py", "Python", 0, 0, 0, -43, 0, -4, -11, -58
"c:\Users\edwar\OneDrive\Documents\Programming\Visual Studio 2022\PARTS_Web\app\env_web\Lib\site-packages\pip\_vendor\urllib3\util\queue.py", "Python", 0, 0, 0, -14, 0, -1, -8, -23
"c:\Users\edwar\OneDrive\Documents\Programming\Visual Studio 2022\PARTS_Web\app\env_web\Lib\site-packages\pip\_vendor\urllib3\util\request.py", "Python", 0, 0, 0, -103, 0, -6, -29, -138
"c:\Users\edwar\OneDrive\Documents\Programming\Visual Studio 2022\PARTS_Web\app\env_web\Lib\site-packages\pip\_vendor\urllib3\util\response.py", "Python", 0, 0, 0, -64, 0, -20, -24, -108
"c:\Users\edwar\OneDrive\Documents\Programming\Visual Studio 2022\PARTS_Web\app\env_web\Lib\site-packages\pip\_vendor\urllib3\util\retry.py", "Python", 0, 0, 0, -469, 0, -29, -123, -621
"c:\Users\edwar\OneDrive\Documents\Programming\Visual Studio 2022\PARTS_Web\app\env_web\Lib\site-packages\pip\_vendor\urllib3\util\ssl_.py", "Python", 0, 0, 0, -352, 0, -59, -85, -496
"c:\Users\edwar\OneDrive\Documents\Programming\Visual Studio 2022\PARTS_Web\app\env_web\Lib\site-packages\pip\_vendor\urllib3\util\ssl_match_hostname.py", "Python", 0, 0, 0, -99, 0, -37, -24, -160
"c:\Users\edwar\OneDrive\Documents\Programming\Visual Studio 2022\PARTS_Web\app\env_web\Lib\site-packages\pip\_vendor\urllib3\util\ssltransport.py", "Python", 0, 0, 0, -178, 0, -2, -42, -222
"c:\Users\edwar\OneDrive\Documents\Programming\Visual Studio 2022\PARTS_Web\app\env_web\Lib\site-packages\pip\_vendor\urllib3\util\timeout.py", "Python", 0, 0, 0, -200, 0, -11, -61, -272
"c:\Users\edwar\OneDrive\Documents\Programming\Visual Studio 2022\PARTS_Web\app\env_web\Lib\site-packages\pip\_vendor\urllib3\util\url.py", "Python", 0, 0, 0, -320, 0, -37, -79, -436
"c:\Users\edwar\OneDrive\Documents\Programming\Visual Studio 2022\PARTS_Web\app\env_web\Lib\site-packages\pip\_vendor\urllib3\util\wait.py", "Python", 0, 0, 0, -89, 0, -38, -26, -153
"c:\Users\edwar\OneDrive\Documents\Programming\Visual Studio 2022\PARTS_Web\app\env_web\Lib\site-packages\pip\_vendor\webencodings\__init__.py", "Python", 0, 0, 0, -249, 0, -14, -80, -343
"c:\Users\edwar\OneDrive\Documents\Programming\Visual Studio 2022\PARTS_Web\app\env_web\Lib\site-packages\pip\_vendor\webencodings\labels.py", "Python", 0, 0, 0, -223, 0, -2, -7, -232
"c:\Users\edwar\OneDrive\Documents\Programming\Visual Studio 2022\PARTS_Web\app\env_web\Lib\site-packages\pip\_vendor\webencodings\mklabels.py", "Python", 0, 0, 0, -40, 0, -2, -18, -60
"c:\Users\edwar\OneDrive\Documents\Programming\Visual Studio 2022\PARTS_Web\app\env_web\Lib\site-packages\pip\_vendor\webencodings\tests.py", "Python", 0, 0, 0, -123, 0, -2, -29, -154
"c:\Users\edwar\OneDrive\Documents\Programming\Visual Studio 2022\PARTS_Web\app\env_web\Lib\site-packages\pip\_vendor\webencodings\x_user_defined.py", "Python", 0, 0, 0, -292, 0, -7, -27, -326
"c:\Users\edwar\OneDrive\Documents\Programming\Visual Studio 2022\PARTS_Web\app\env_web\Lib\site-packages\pkg_resources\__init__.py", "Python", 0, 0, 0, -2468, 0, -167, -654, -3289
"c:\Users\edwar\OneDrive\Documents\Programming\Visual Studio 2022\PARTS_Web\app\env_web\Lib\site-packages\pkg_resources\_vendor\__init__.py", "Python", 0, 0, 0, 0, 0, 0, -1, -1
"c:\Users\edwar\OneDrive\Documents\Programming\Visual Studio 2022\PARTS_Web\app\env_web\Lib\site-packages\pkg_resources\_vendor\appdirs.py", "Python", 0, 0, 0, -493, 0, -27, -89, -609
"c:\Users\edwar\OneDrive\Documents\Programming\Visual Studio 2022\PARTS_Web\app\env_web\Lib\site-packages\pkg_resources\_vendor\packaging\__about__.py", "Python", 0, 0, 0, -19, 0, -3, -6, -28
"c:\Users\edwar\OneDrive\Documents\Programming\Visual Studio 2022\PARTS_Web\app\env_web\Lib\site-packages\pkg_resources\_vendor\packaging\__init__.py", "Python", 0, 0, 0, -21, 0, -3, -3, -27
"c:\Users\edwar\OneDrive\Documents\Programming\Visual Studio 2022\PARTS_Web\app\env_web\Lib\site-packages\pkg_resources\_vendor\packaging\_compat.py", "Python", 0, 0, 0, -19, 0, -9, -11, -39
"c:\Users\edwar\OneDrive\Documents\Programming\Visual Studio 2022\PARTS_Web\app\env_web\Lib\site-packages\pkg_resources\_vendor\packaging\_structures.py", "Python", 0, 0, 0, -41, 0, -21, -25, -87
"c:\Users\edwar\OneDrive\Documents\Programming\Visual Studio 2022\PARTS_Web\app\env_web\Lib\site-packages\pkg_resources\_vendor\packaging\_typing.py", "Python", 0, 0, 0, -29, 0, -8, -12, -49
"c:\Users\edwar\OneDrive\Documents\Programming\Visual Studio 2022\PARTS_Web\app\env_web\Lib\site-packages\pkg_resources\_vendor\packaging\markers.py", "Python", 0, 0, 0, -224, 0, -28, -77, -329
"c:\Users\edwar\OneDrive\Documents\Programming\Visual Studio 2022\PARTS_Web\app\env_web\Lib\site-packages\pkg_resources\_vendor\packaging\requirements.py", "Python", 0, 0, 0, -100, 0, -12, -34, -146
"c:\Users\edwar\OneDrive\Documents\Programming\Visual Studio 2022\PARTS_Web\app\env_web\Lib\site-packages\pkg_resources\_vendor\packaging\specifiers.py", "Python", 0, 0, 0, -490, 0, -216, -158, -864
"c:\Users\edwar\OneDrive\Documents\Programming\Visual Studio 2022\PARTS_Web\app\env_web\Lib\site-packages\pkg_resources\_vendor\packaging\tags.py", "Python", 0, 0, 0, -543, 0, -88, -121, -752
"c:\Users\edwar\OneDrive\Documents\Programming\Visual Studio 2022\PARTS_Web\app\env_web\Lib\site-packages\pkg_resources\_vendor\packaging\utils.py", "Python", 0, 0, 0, -33, 0, -14, -19, -66
"c:\Users\edwar\OneDrive\Documents\Programming\Visual Studio 2022\PARTS_Web\app\env_web\Lib\site-packages\pkg_resources\_vendor\packaging\version.py", "Python", 0, 0, 0, -325, 0, -100, -111, -536
"c:\Users\edwar\OneDrive\Documents\Programming\Visual Studio 2022\PARTS_Web\app\env_web\Lib\site-packages\pkg_resources\_vendor\pyparsing.py", "Python", 0, 0, 0, -4648, 0, -255, -840, -5743
"c:\Users\edwar\OneDrive\Documents\Programming\Visual Studio 2022\PARTS_Web\app\env_web\Lib\site-packages\pkg_resources\extern\__init__.py", "Python", 0, 0, 0, -61, 0, 0, -13, -74
"c:\Users\edwar\OneDrive\Documents\Programming\Visual Studio 2022\PARTS_Web\app\env_web\Lib\site-packages\pkg_resources\tests\data\my-test-package-source\setup.py", "Python", 0, 0, 0, -6, 0, 0, -1, -7
"c:\Users\edwar\OneDrive\Documents\Programming\Visual Studio 2022\PARTS_Web\app\env_web\Lib\site-packages\setuptools\__init__.py", "Python", 0, 0, 0, -174, 0, -13, -55, -242
"c:\Users\edwar\OneDrive\Documents\Programming\Visual Studio 2022\PARTS_Web\app\env_web\Lib\site-packages\setuptools\_deprecation_warning.py", "Python", 0, 0, 0, -6, 0, 0, -2, -8
"c:\Users\edwar\OneDrive\Documents\Programming\Visual Studio 2022\PARTS_Web\app\env_web\Lib\site-packages\setuptools\_distutils\__init__.py", "Python", 0, 0, 0, -9, 0, 0, -7, -16
"c:\Users\edwar\OneDrive\Documents\Programming\Visual Studio 2022\PARTS_Web\app\env_web\Lib\site-packages\setuptools\_distutils\_msvccompiler.py", "Python", 0, 0, 0, -414, 0, -60, -88, -562
"c:\Users\edwar\OneDrive\Documents\Programming\Visual Studio 2022\PARTS_Web\app\env_web\Lib\site-packages\setuptools\_distutils\archive_util.py", "Python", 0, 0, 0, -202, 0, -8, -47, -257
"c:\Users\edwar\OneDrive\Documents\Programming\Visual Studio 2022\PARTS_Web\app\env_web\Lib\site-packages\setuptools\_distutils\bcppcompiler.py", "Python", 0, 0, 0, -248, 0, -78, -68, -394
"c:\Users\edwar\OneDrive\Documents\Programming\Visual Studio 2022\PARTS_Web\app\env_web\Lib\site-packages\setuptools\_distutils\ccompiler.py", "Python", 0, 0, 0, -799, 0, -156, -162, -1117
"c:\Users\edwar\OneDrive\Documents\Programming\Visual Studio 2022\PARTS_Web\app\env_web\Lib\site-packages\setuptools\_distutils\cmd.py", "Python", 0, 0, 0, -275, 0, -71, -58, -404
"c:\Users\edwar\OneDrive\Documents\Programming\Visual Studio 2022\PARTS_Web\app\env_web\Lib\site-packages\setuptools\_distutils\command\__init__.py", "Python", 0, 0, 0, -23, 0, -6, -3, -32
"c:\Users\edwar\OneDrive\Documents\Programming\Visual Studio 2022\PARTS_Web\app\env_web\Lib\site-packages\setuptools\_distutils\command\bdist.py", "Python", 0, 0, 0, -105, 0, -14, -25, -144
"c:\Users\edwar\OneDrive\Documents\Programming\Visual Studio 2022\PARTS_Web\app\env_web\Lib\site-packages\setuptools\_distutils\command\bdist_dumb.py", "Python", 0, 0, 0, -102, 0, -3, -19, -124
"c:\Users\edwar\OneDrive\Documents\Programming\Visual Studio 2022\PARTS_Web\app\env_web\Lib\site-packages\setuptools\_distutils\command\bdist_msi.py", "Python", 0, 0, 0, -570, 0, -93, -87, -750
"c:\Users\edwar\OneDrive\Documents\Programming\Visual Studio 2022\PARTS_Web\app\env_web\Lib\site-packages\setuptools\_distutils\command\bdist_rpm.py", "Python", 0, 0, 0, -435, 0, -59, -86, -580
"c:\Users\edwar\OneDrive\Documents\Programming\Visual Studio 2022\PARTS_Web\app\env_web\Lib\site-packages\setuptools\_distutils\command\bdist_wininst.py", "Python", 0, 0, 0, -265, 0, -61, -52, -378
"c:\Users\edwar\OneDrive\Documents\Programming\Visual Studio 2022\PARTS_Web\app\env_web\Lib\site-packages\setuptools\_distutils\command\build.py", "Python", 0, 0, 0, -107, 0, -22, -29, -158
"c:\Users\edwar\OneDrive\Documents\Programming\Visual Studio 2022\PARTS_Web\app\env_web\Lib\site-packages\setuptools\_distutils\command\build_clib.py", "Python", 0, 0, 0, -138, 0, -27, -45, -210
"c:\Users\edwar\OneDrive\Documents\Programming\Visual Studio 2022\PARTS_Web\app\env_web\Lib\site-packages\setuptools\_distutils\command\build_ext.py", "Python", 0, 0, 0, -500, 0, -153, -103, -756
"c:\Users\edwar\OneDrive\Documents\Programming\Visual Studio 2022\PARTS_Web\app\env_web\Lib\site-packages\setuptools\_distutils\command\build_py.py", "Python", 0, 0, 0, -277, 0, -81, -59, -417
"c:\Users\edwar\OneDrive\Documents\Programming\Visual Studio 2022\PARTS_Web\app\env_web\Lib\site-packages\setuptools\_distutils\command\build_scripts.py", "Python", 0, 0, 0, -126, 0, -13, -22, -161
"c:\Users\edwar\OneDrive\Documents\Programming\Visual Studio 2022\PARTS_Web\app\env_web\Lib\site-packages\setuptools\_distutils\command\check.py", "Python", 0, 0, 0, -118, 0, -7, -24, -149
"c:\Users\edwar\OneDrive\Documents\Programming\Visual Studio 2022\PARTS_Web\app\env_web\Lib\site-packages\setuptools\_distutils\command\clean.py", "Python", 0, 0, 0, -59, 0, -6, -12, -77
"c:\Users\edwar\OneDrive\Documents\Programming\Visual Studio 2022\PARTS_Web\app\env_web\Lib\site-packages\setuptools\_distutils\command\config.py", "Python", 0, 0, 0, -273, 0, -21, -51, -345
"c:\Users\edwar\OneDrive\Documents\Programming\Visual Studio 2022\PARTS_Web\app\env_web\Lib\site-packages\setuptools\_distutils\command\install.py", "Python", 0, 0, 0, -452, 0, -122, -104, -678
"c:\Users\edwar\OneDrive\Documents\Programming\Visual Studio 2022\PARTS_Web\app\env_web\Lib\site-packages\setuptools\_distutils\command\install_data.py", "Python", 0, 0, 0, -59, 0, -7, -14, -80
"c:\Users\edwar\OneDrive\Documents\Programming\Visual Studio 2022\PARTS_Web\app\env_web\Lib\site-packages\setuptools\_distutils\command\install_egg_info.py", "Python", 0, 0, 0, -55, 0, -3, -20, -78
"c:\Users\edwar\OneDrive\Documents\Programming\Visual Studio 2022\PARTS_Web\app\env_web\Lib\site-packages\setuptools\_distutils\command\install_headers.py", "Python", 0, 0, 0, -32, 0, -1, -15, -48
"c:\Users\edwar\OneDrive\Documents\Programming\Visual Studio 2022\PARTS_Web\app\env_web\Lib\site-packages\setuptools\_distutils\command\install_lib.py", "Python", 0, 0, 0, -140, 0, -36, -42, -218
"c:\Users\edwar\OneDrive\Documents\Programming\Visual Studio 2022\PARTS_Web\app\env_web\Lib\site-packages\setuptools\_distutils\command\install_scripts.py", "Python", 0, 0, 0, -44, 0, -3, -14, -61
"c:\Users\edwar\OneDrive\Documents\Programming\Visual Studio 2022\PARTS_Web\app\env_web\Lib\site-packages\setuptools\_distutils\command\py37compat.py", "Python", 0, 0, 0, -23, 0, 0, -8, -31
"c:\Users\edwar\OneDrive\Documents\Programming\Visual Studio 2022\PARTS_Web\app\env_web\Lib\site-packages\setuptools\_distutils\command\register.py", "Python", 0, 0, 0, -251, 0, -20, -34, -305
"c:\Users\edwar\OneDrive\Documents\Programming\Visual Studio 2022\PARTS_Web\app\env_web\Lib\site-packages\setuptools\_distutils\command\sdist.py", "Python", 0, 0, 0, -373, 0, -47, -75, -495
"c:\Users\edwar\OneDrive\Documents\Programming\Visual Studio 2022\PARTS_Web\app\env_web\Lib\site-packages\setuptools\_distutils\command\upload.py", "Python", 0, 0, 0, -162, 0, -22, -31, -215
"c:\Users\edwar\OneDrive\Documents\Programming\Visual Studio 2022\PARTS_Web\app\env_web\Lib\site-packages\setuptools\_distutils\config.py", "Python", 0, 0, 0, -103, 0, -9, -19, -131
"c:\Users\edwar\OneDrive\Documents\Programming\Visual Studio 2022\PARTS_Web\app\env_web\Lib\site-packages\setuptools\_distutils\core.py", "Python", 0, 0, 0, -170, 0, -25, -40, -235
"c:\Users\edwar\OneDrive\Documents\Programming\Visual Studio 2022\PARTS_Web\app\env_web\Lib\site-packages\setuptools\_distutils\cygwinccompiler.py", "Python", 0, 0, 0, -237, 0, -111, -56, -404
"c:\Users\edwar\OneDrive\Documents\Programming\Visual Studio 2022\PARTS_Web\app\env_web\Lib\site-packages\setuptools\_distutils\debug.py", "Python", 0, 0, 0, -2, 0, -2, -2, -6
"c:\Users\edwar\OneDrive\Documents\Programming\Visual Studio 2022\PARTS_Web\app\env_web\Lib\site-packages\setuptools\_distutils\dep_util.py", "Python", 0, 0, 0, -66, 0, -9, -18, -93
"c:\Users\edwar\OneDrive\Documents\Programming\Visual Studio 2022\PARTS_Web\app\env_web\Lib\site-packages\setuptools\_distutils\dir_util.py", "Python", 0, 0, 0, -156, 0, -18, -37, -211
"c:\Users\edwar\OneDrive\Documents\Programming\Visual Studio 2022\PARTS_Web\app\env_web\Lib\site-packages\setuptools\_distutils\dist.py", "Python", 0, 0, 0, -900, 0, -164, -194, -1258
"c:\Users\edwar\OneDrive\Documents\Programming\Visual Studio 2022\PARTS_Web\app\env_web\Lib\site-packages\setuptools\_distutils\errors.py", "Python", 0, 0, 0, -75, 0, -1, -22, -98
"c:\Users\edwar\OneDrive\Documents\Programming\Visual Studio 2022\PARTS_Web\app\env_web\Lib\site-packages\setuptools\_distutils\extension.py", "Python", 0, 0, 0, -189, 0, -27, -25, -241
"c:\Users\edwar\OneDrive\Documents\Programming\Visual Studio 2022\PARTS_Web\app\env_web\Lib\site-packages\setuptools\_distutils\fancy_getopt.py", "Python", 0, 0, 0, -308, 0, -78, -72, -458
"c:\Users\edwar\OneDrive\Documents\Programming\Visual Studio 2022\PARTS_Web\app\env_web\Lib\site-packages\setuptools\_distutils\file_util.py", "Python", 0, 0, 0, -181, 0, -19, -39, -239
"c:\Users\edwar\OneDrive\Documents\Programming\Visual Studio 2022\PARTS_Web\app\env_web\Lib\site-packages\setuptools\_distutils\filelist.py", "Python", 0, 0, 0, -243, 0, -28, -57, -328
"c:\Users\edwar\OneDrive\Documents\Programming\Visual Studio 2022\PARTS_Web\app\env_web\Lib\site-packages\setuptools\_distutils\log.py", "Python", 0, 0, 0, -57, 0, -4, -17, -78
"c:\Users\edwar\OneDrive\Documents\Programming\Visual Studio 2022\PARTS_Web\app\env_web\Lib\site-packages\setuptools\_distutils\msvc9compiler.py", "Python", 0, 0, 0, -584, 0, -107, -98, -789
"c:\Users\edwar\OneDrive\Documents\Programming\Visual Studio 2022\PARTS_Web\app\env_web\Lib\site-packages\setuptools\_distutils\msvccompiler.py", "Python", 0, 0, 0, -493, 0, -62, -89, -644
"c:\Users\edwar\OneDrive\Documents\Programming\Visual Studio 2022\PARTS_Web\app\env_web\Lib\site-packages\setuptools\_distutils\py35compat.py", "Python", 0, 0, 0, -15, 0, 0, -5, -20
"c:\Users\edwar\OneDrive\Documents\Programming\Visual Studio 2022\PARTS_Web\app\env_web\Lib\site-packages\setuptools\_distutils\py38compat.py", "Python", 0, 0, 0, -7, 0, 0, -1, -8
"c:\Users\edwar\OneDrive\Documents\Programming\Visual Studio 2022\PARTS_Web\app\env_web\Lib\site-packages\setuptools\_distutils\spawn.py", "Python", 0, 0, 0, -92, 0, -10, -24, -126
"c:\Users\edwar\OneDrive\Documents\Programming\Visual Studio 2022\PARTS_Web\app\env_web\Lib\site-packages\setuptools\_distutils\sysconfig.py", "Python", 0, 0, 0, -412, 0, -81, -81, -574
"c:\Users\edwar\OneDrive\Documents\Programming\Visual Studio 2022\PARTS_Web\app\env_web\Lib\site-packages\setuptools\_distutils\text_file.py", "Python", 0, 0, 0, -203, 0, -43, -41, -287
"c:\Users\edwar\OneDrive\Documents\Programming\Visual Studio 2022\PARTS_Web\app\env_web\Lib\site-packages\setuptools\_distutils\unixccompiler.py", "Python", 0, 0, 0, -198, 0, -90, -41, -329
"c:\Users\edwar\OneDrive\Documents\Programming\Visual Studio 2022\PARTS_Web\app\env_web\Lib\site-packages\setuptools\_distutils\util.py", "Python", 0, 0, 0, -404, 0, -69, -89, -562
"c:\Users\edwar\OneDrive\Documents\Programming\Visual Studio 2022\PARTS_Web\app\env_web\Lib\site-packages\setuptools\_distutils\version.py", "Python", 0, 0, 0, -191, 0, -98, -59, -348
"c:\Users\edwar\OneDrive\Documents\Programming\Visual Studio 2022\PARTS_Web\app\env_web\Lib\site-packages\setuptools\_distutils\versionpredicate.py", "Python", 0, 0, 0, -129, 0, -5, -33, -167
"c:\Users\edwar\OneDrive\Documents\Programming\Visual Studio 2022\PARTS_Web\app\env_web\Lib\site-packages\setuptools\_imp.py", "Python", 0, 0, 0, -66, 0, 0, -17, -83
"c:\Users\edwar\OneDrive\Documents\Programming\Visual Studio 2022\PARTS_Web\app\env_web\Lib\site-packages\setuptools\_vendor\__init__.py", "Python", 0, 0, 0, 0, 0, 0, -1, -1
"c:\Users\edwar\OneDrive\Documents\Programming\Visual Studio 2022\PARTS_Web\app\env_web\Lib\site-packages\setuptools\_vendor\ordered_set.py", "Python", 0, 0, 0, -405, 0, -15, -69, -489
"c:\Users\edwar\OneDrive\Documents\Programming\Visual Studio 2022\PARTS_Web\app\env_web\Lib\site-packages\setuptools\_vendor\packaging\__about__.py", "Python", 0, 0, 0, -19, 0, -3, -6, -28
"c:\Users\edwar\OneDrive\Documents\Programming\Visual Studio 2022\PARTS_Web\app\env_web\Lib\site-packages\setuptools\_vendor\packaging\__init__.py", "Python", 0, 0, 0, -21, 0, -3, -3, -27
"c:\Users\edwar\OneDrive\Documents\Programming\Visual Studio 2022\PARTS_Web\app\env_web\Lib\site-packages\setuptools\_vendor\packaging\_compat.py", "Python", 0, 0, 0, -19, 0, -9, -11, -39
"c:\Users\edwar\OneDrive\Documents\Programming\Visual Studio 2022\PARTS_Web\app\env_web\Lib\site-packages\setuptools\_vendor\packaging\_structures.py", "Python", 0, 0, 0, -41, 0, -21, -25, -87
"c:\Users\edwar\OneDrive\Documents\Programming\Visual Studio 2022\PARTS_Web\app\env_web\Lib\site-packages\setuptools\_vendor\packaging\_typing.py", "Python", 0, 0, 0, -29, 0, -8, -12, -49
"c:\Users\edwar\OneDrive\Documents\Programming\Visual Studio 2022\PARTS_Web\app\env_web\Lib\site-packages\setuptools\_vendor\packaging\markers.py", "Python", 0, 0, 0, -224, 0, -28, -77, -329
"c:\Users\edwar\OneDrive\Documents\Programming\Visual Studio 2022\PARTS_Web\app\env_web\Lib\site-packages\setuptools\_vendor\packaging\requirements.py", "Python", 0, 0, 0, -100, 0, -12, -34, -146
"c:\Users\edwar\OneDrive\Documents\Programming\Visual Studio 2022\PARTS_Web\app\env_web\Lib\site-packages\setuptools\_vendor\packaging\specifiers.py", "Python", 0, 0, 0, -490, 0, -216, -158, -864
"c:\Users\edwar\OneDrive\Documents\Programming\Visual Studio 2022\PARTS_Web\app\env_web\Lib\site-packages\setuptools\_vendor\packaging\tags.py", "Python", 0, 0, 0, -543, 0, -88, -121, -752
"c:\Users\edwar\OneDrive\Documents\Programming\Visual Studio 2022\PARTS_Web\app\env_web\Lib\site-packages\setuptools\_vendor\packaging\utils.py", "Python", 0, 0, 0, -33, 0, -14, -19, -66
"c:\Users\edwar\OneDrive\Documents\Programming\Visual Studio 2022\PARTS_Web\app\env_web\Lib\site-packages\setuptools\_vendor\packaging\version.py", "Python", 0, 0, 0, -325, 0, -100, -111, -536
"c:\Users\edwar\OneDrive\Documents\Programming\Visual Studio 2022\PARTS_Web\app\env_web\Lib\site-packages\setuptools\_vendor\pyparsing.py", "Python", 0, 0, 0, -4648, 0, -255, -840, -5743
"c:\Users\edwar\OneDrive\Documents\Programming\Visual Studio 2022\PARTS_Web\app\env_web\Lib\site-packages\setuptools\archive_util.py", "Python", 0, 0, 0, -156, 0, -8, -42, -206
"c:\Users\edwar\OneDrive\Documents\Programming\Visual Studio 2022\PARTS_Web\app\env_web\Lib\site-packages\setuptools\build_meta.py", "Python", 0, 0, 0, -200, 0, -20, -62, -282
"c:\Users\edwar\OneDrive\Documents\Programming\Visual Studio 2022\PARTS_Web\app\env_web\Lib\site-packages\setuptools\command\__init__.py", "Python", 0, 0, 0, -13, 0, 0, -5, -18
"c:\Users\edwar\OneDrive\Documents\Programming\Visual Studio 2022\PARTS_Web\app\env_web\Lib\site-packages\setuptools\command\alias.py", "Python", 0, 0, 0, -62, 0, 0, -17, -79
"c:\Users\edwar\OneDrive\Documents\Programming\Visual Studio 2022\PARTS_Web\app\env_web\Lib\site-packages\setuptools\command\bdist_egg.py", "Python", 0, 0, 0, -362, 0, -17, -78, -457
"c:\Users\edwar\OneDrive\Documents\Programming\Visual Studio 2022\PARTS_Web\app\env_web\Lib\site-packages\setuptools\command\bdist_rpm.py", "Python", 0, 0, 0, -24, 0, -1, -7, -32
"c:\Users\edwar\OneDrive\Documents\Programming\Visual Studio 2022\PARTS_Web\app\env_web\Lib\site-packages\setuptools\command\build_clib.py", "Python", 0, 0, 0, -77, 0, -13, -12, -102
"c:\Users\edwar\OneDrive\Documents\Programming\Visual Studio 2022\PARTS_Web\app\env_web\Lib\site-packages\setuptools\command\build_ext.py", "Python", 0, 0, 0, -255, 0, -30, -38, -323
"c:\Users\edwar\OneDrive\Documents\Programming\Visual Studio 2022\PARTS_Web\app\env_web\Lib\site-packages\setuptools\command\build_py.py", "Python", 0, 0, 0, -216, 0, -13, -42, -271
"c:\Users\edwar\OneDrive\Documents\Programming\Visual Studio 2022\PARTS_Web\app\env_web\Lib\site-packages\setuptools\command\develop.py", "Python", 0, 0, 0, -162, 0, -17, -38, -217
"c:\Users\edwar\OneDrive\Documents\Programming\Visual Studio 2022\PARTS_Web\app\env_web\Lib\site-packages\setuptools\command\dist_info.py", "Python", 0, 0, 0, -26, 0, 0, -11, -37
"c:\Users\edwar\OneDrive\Documents\Programming\Visual Studio 2022\PARTS_Web\app\env_web\Lib\site-packages\setuptools\command\easy_install.py", "Python", 0, 0, 0, -1804, 0, -147, -340, -2291
"c:\Users\edwar\OneDrive\Documents\Programming\Visual Studio 2022\PARTS_Web\app\env_web\Lib\site-packages\setuptools\command\egg_info.py", "Python", 0, 0, 0, -554, 0, -53, -121, -728
"c:\Users\edwar\OneDrive\Documents\Programming\Visual Studio 2022\PARTS_Web\app\env_web\Lib\site-packages\setuptools\command\install.py", "Python", 0, 0, 0, -94, 0, -10, -22, -126
"c:\Users\edwar\OneDrive\Documents\Programming\Visual Studio 2022\PARTS_Web\app\env_web\Lib\site-packages\setuptools\command\install_egg_info.py", "Python", 0, 0, 0, -47, 0, -4, -12, -63
"c:\Users\edwar\OneDrive\Documents\Programming\Visual Studio 2022\PARTS_Web\app\env_web\Lib\site-packages\setuptools\command\install_lib.py", "Python", 0, 0, 0, -93, 0, -6, -24, -123
"c:\Users\edwar\OneDrive\Documents\Programming\Visual Studio 2022\PARTS_Web\app\env_web\Lib\site-packages\setuptools\command\install_scripts.py", "Python", 0, 0, 0, -55, 0, -4, -11, -70
"c:\Users\edwar\OneDrive\Documents\Programming\Visual Studio 2022\PARTS_Web\app\env_web\Lib\site-packages\setuptools\command\launcher manifest.xml", "XML", 0, 0, 0, 0, -14, -1, -1, -16
"c:\Users\edwar\OneDrive\Documents\Programming\Visual Studio 2022\PARTS_Web\app\env_web\Lib\site-packages\setuptools\command\py36compat.py", "Python", 0, 0, 0, -105, 0, -11, -19, -135
"c:\Users\edwar\OneDrive\Documents\Programming\Visual Studio 2022\PARTS_Web\app\env_web\Lib\site-packages\setuptools\command\register.py", "Python", 0, 0, 0, -12, 0, 0, -7, -19
"c:\Users\edwar\OneDrive\Documents\Programming\Visual Studio 2022\PARTS_Web\app\env_web\Lib\site-packages\setuptools\command\rotate.py", "Python", 0, 0, 0, -54, 0, 0, -11, -65
"c:\Users\edwar\OneDrive\Documents\Programming\Visual Studio 2022\PARTS_Web\app\env_web\Lib\site-packages\setuptools\command\saveopts.py", "Python", 0, 0, 0, -14, 0, 0, -9, -23
"c:\Users\edwar\OneDrive\Documents\Programming\Visual Studio 2022\PARTS_Web\app\env_web\Lib\site-packages\setuptools\command\sdist.py", "Python", 0, 0, 0, -183, 0, -11, -42, -236
"c:\Users\edwar\OneDrive\Documents\Programming\Visual Studio 2022\PARTS_Web\app\env_web\Lib\site-packages\setuptools\command\setopt.py", "Python", 0, 0, 0, -125, 0, 0, -24, -149
"c:\Users\edwar\OneDrive\Documents\Programming\Visual Studio 2022\PARTS_Web\app\env_web\Lib\site-packages\setuptools\command\test.py", "Python", 0, 0, 0, -219, 0, -9, -47, -275
"c:\Users\edwar\OneDrive\Documents\Programming\Visual Studio 2022\PARTS_Web\app\env_web\Lib\site-packages\setuptools\command\upload.py", "Python", 0, 0, 0, -12, 0, 0, -6, -18
"c:\Users\edwar\OneDrive\Documents\Programming\Visual Studio 2022\PARTS_Web\app\env_web\Lib\site-packages\setuptools\command\upload_docs.py", "Python", 0, 0, 0, -169, 0, -9, -25, -203
"c:\Users\edwar\OneDrive\Documents\Programming\Visual Studio 2022\PARTS_Web\app\env_web\Lib\site-packages\setuptools\config.py", "Python", 0, 0, 0, -538, 0, -10, -163, -711
"c:\Users\edwar\OneDrive\Documents\Programming\Visual Studio 2022\PARTS_Web\app\env_web\Lib\site-packages\setuptools\dep_util.py", "Python", 0, 0, 0, -17, 0, -4, -5, -26
"c:\Users\edwar\OneDrive\Documents\Programming\Visual Studio 2022\PARTS_Web\app\env_web\Lib\site-packages\setuptools\depends.py", "Python", 0, 0, 0, -129, 0, -3, -44, -176
"c:\Users\edwar\OneDrive\Documents\Programming\Visual Studio 2022\PARTS_Web\app\env_web\Lib\site-packages\setuptools\dist.py", "Python", 0, 0, 0, -828, 0, -45, -185, -1058
"c:\Users\edwar\OneDrive\Documents\Programming\Visual Studio 2022\PARTS_Web\app\env_web\Lib\site-packages\setuptools\errors.py", "Python", 0, 0, 0, -11, 0, 0, -6, -17
"c:\Users\edwar\OneDrive\Documents\Programming\Visual Studio 2022\PARTS_Web\app\env_web\Lib\site-packages\setuptools\extension.py", "Python", 0, 0, 0, -38, 0, -5, -13, -56
"c:\Users\edwar\OneDrive\Documents\Programming\Visual Studio 2022\PARTS_Web\app\env_web\Lib\site-packages\setuptools\extern\__init__.py", "Python", 0, 0, 0, -61, 0, 0, -13, -74
"c:\Users\edwar\OneDrive\Documents\Programming\Visual Studio 2022\PARTS_Web\app\env_web\Lib\site-packages\setuptools\glob.py", "Python", 0, 0, 0, -118, 0, -14, -36, -168
"c:\Users\edwar\OneDrive\Documents\Programming\Visual Studio 2022\PARTS_Web\app\env_web\Lib\site-packages\setuptools\installer.py", "Python", 0, 0, 0, -80, 0, -9, -9, -98
"c:\Users\edwar\OneDrive\Documents\Programming\Visual Studio 2022\PARTS_Web\app\env_web\Lib\site-packages\setuptools\launch.py", "Python", 0, 0, 0, -27, 0, -2, -8, -37
"c:\Users\edwar\OneDrive\Documents\Programming\Visual Studio 2022\PARTS_Web\app\env_web\Lib\site-packages\setuptools\lib2to3_ex.py", "Python", 0, 0, 0, -54, 0, -2, -13, -69
"c:\Users\edwar\OneDrive\Documents\Programming\Visual Studio 2022\PARTS_Web\app\env_web\Lib\site-packages\setuptools\monkey.py", "Python", 0, 0, 0, -124, 0, -14, -40, -178
"c:\Users\edwar\OneDrive\Documents\Programming\Visual Studio 2022\PARTS_Web\app\env_web\Lib\site-packages\setuptools\msvc.py", "Python", 0, 0, 0, -1466, 0, -64, -297, -1827
"c:\Users\edwar\OneDrive\Documents\Programming\Visual Studio 2022\PARTS_Web\app\env_web\Lib\site-packages\setuptools\namespaces.py", "Python", 0, 0, 0, -86, 0, -1, -21, -108
"c:\Users\edwar\OneDrive\Documents\Programming\Visual Studio 2022\PARTS_Web\app\env_web\Lib\site-packages\setuptools\package_index.py", "Python", 0, 0, 0, -902, 0, -63, -181, -1146
"c:\Users\edwar\OneDrive\Documents\Programming\Visual Studio 2022\PARTS_Web\app\env_web\Lib\site-packages\setuptools\py34compat.py", "Python", 0, 0, 0, -10, 0, 0, -4, -14
"c:\Users\edwar\OneDrive\Documents\Programming\Visual Studio 2022\PARTS_Web\app\env_web\Lib\site-packages\setuptools\sandbox.py", "Python", 0, 0, 0, -384, 0, -9, -104, -497
"c:\Users\edwar\OneDrive\Documents\Programming\Visual Studio 2022\PARTS_Web\app\env_web\Lib\site-packages\setuptools\ssl_support.py", "Python", 0, 0, 0, -189, 0, -31, -47, -267
"c:\Users\edwar\OneDrive\Documents\Programming\Visual Studio 2022\PARTS_Web\app\env_web\Lib\site-packages\setuptools\unicode_utils.py", "Python", 0, 0, 0, -32, 0, -1, -10, -43
"c:\Users\edwar\OneDrive\Documents\Programming\Visual Studio 2022\PARTS_Web\app\env_web\Lib\site-packages\setuptools\version.py", "Python", 0, 0, 0, -5, 0, 0, -2, -7
"c:\Users\edwar\OneDrive\Documents\Programming\Visual Studio 2022\PARTS_Web\app\env_web\Lib\site-packages\setuptools\wheel.py", "Python", 0, 0, 0, -178, 0, -13, -23, -214
"c:\Users\edwar\OneDrive\Documents\Programming\Visual Studio 2022\PARTS_Web\app\env_web\Lib\site-packages\setuptools\windows_support.py", "Python", 0, 0, 0, -21, 0, 0, -9, -30
"c:\Users\edwar\OneDrive\Documents\Programming\Visual Studio 2022\PARTS_Web\app\env_web\Scripts\Activate.ps1", "PowerShell", 0, 0, -108, 0, 0, -360, -35, -503
"c:\Users\edwar\OneDrive\Documents\Programming\Visual Studio 2022\PARTS_Web\app\env_web\Scripts\activate.bat", "Batch", 0, -24, 0, 0, 0, -1, -10, -35
"c:\Users\edwar\OneDrive\Documents\Programming\Visual Studio 2022\PARTS_Web\app\env_web\Scripts\deactivate.bat", "Batch", 0, -16, 0, 0, 0, 0, -7, -23
"c:\Users\edwar\OneDrive\Documents\Programming\Visual Studio 2022\PARTS_Web\app\env_web\pyvenv.cfg", "Properties", -5, 0, 0, 0, 0, 0, -1, -6
"Total", "-", -18, -158, -428, -685583, -28, -44464, -103319, -833998